government-domain	organisation	start-date	end-date
101.gov.uk	"government-organisation:D16"		
abinger-pc.gov.uk	"local-authority-eng:MOL"		
accessni.gov.uk	"government-organisation:D19"		
acnfp.gov.uk	"government-organisation:D102"		
adurdc.gov.uk	"local-authority-eng:ADU"		
adur.gov.uk	"local-authority-eng:ADU"		
adur-worthing.gov.uk	"local-authority-eng:ADU"		
aebc.gov.uk	"government-organisation:D1198"		
agepositive.gov.uk	"government-organisation:D10"		
ahmlr.gov.uk	"government-organisation:D18"		
alderminster-pc.gov.uk	"local-authority-eng:STR"		
allerdale.gov.uk	"local-authority-eng:ALL"		
ambervalley.gov.uk	"local-authority-eng:AMB"		
angliarevenues.gov.uk	"local-authority-eng:SED"		
apc.gov.uk	"government-organisation:D16"		
appeals-service.gov.uk	"government-organisation:D18"		
apprenticeships.gov.uk	"government-organisation:EA765"		
armedforcescovenant.gov.uk	"government-organisation:D17"		
arolygiaeth-gynllunio.gov.uk	"government-organisation:EA39"		
arolygiaethgynllunio.gov.uk	"government-organisation:EA39"		
arun.gov.uk	"local-authority-eng:ARU"		
ashfield-dc.gov.uk	"local-authority-eng:ASH"		
ashfield.gov.uk	"local-authority-eng:ASH"		
ashford.gov.uk	"local-authority-eng:ASF"		
asiantaethcynnalplant.gov.uk	"government-organisation:D10"		
askderbyshire.gov.uk	"local-authority-eng:NED"		
assetsrecovery.gov.uk	"government-organisation:PB265"		
asylum-support-tribunal.gov.uk	"government-organisation:D18"		
audit-commission.gov.uk	"government-organisation:D4"		
aws.gov.uk	"local-authority-eng:WOT"		
aylesbury.gov.uk	"local-authority-eng:AYL"		
aylesburyvaledc.gov.uk	"local-authority-eng:AYL"		
aylesburyvale.gov.uk	"local-authority-eng:AYL"		
babergh.gov.uk	"local-authority-eng:BAB"		
baberghmidsuffolk.gov.uk	"local-authority-eng:BAB"		
badgeworth-pc.gov.uk	"local-authority-eng:STO"		
bagchargewales.gov.uk	"government-organisation:DA1019"		
barnet.gov.uk	"local-authority-eng:BNE"		
barnsley.gov.uk	"local-authority-eng:BNS"		
basingstoke.gov.uk	"local-authority-eng:BAN"		
bassetlaw.gov.uk	"local-authority-eng:BAE"		
bathnes.gov.uk	"local-authority-eng:BAS"		
bcomm-wales.gov.uk	"government-organisation:DA1019"		
bedford.gov.uk	"local-authority-eng:BDF"		
bedscc.gov.uk	"local-authority-eng:BDF"		
bedsparishes.gov.uk	"local-authority-eng:BDF"		
beis.gov.uk	"government-organisation:D1198"		
berr.gov.uk	"government-organisation:D1198"		
betchworth-pc.gov.uk	"local-authority-eng:MOL"		
betterregulation.gov.uk	"government-organisation:D1198"		
bfi.gov.uk	"government-organisation:D10"		
bidfordonavon-pc.gov.uk	"local-authority-eng:STR"		
birmingham.gov.uk	"local-authority-eng:BIR"		
birminghamprepared.gov.uk	"local-authority-eng:BIR"		
bis.gov.uk	"government-organisation:D1198"		
bishopsitchington-pc.gov.uk	"local-authority-eng:STR"		
blaby.gov.uk	"local-authority-eng:BLA"		
blackburn.gov.uk	"local-authority-eng:BBD"		
bmhldni.gov.uk	"government-organisation:D12"		
bolsover.gov.uk	"local-authority-eng:BOS"		
bolton.gov.uk	"local-authority-eng:BOL"		
bonavacantia.gov.uk	"government-organisation:D1108"		
boston.gov.uk	"local-authority-eng:BOT"		
bournemouth.gov.uk	"local-authority-eng:BMH"		
bradford.gov.uk	"local-authority-eng:BRD"		
braintree.gov.uk	"local-authority-eng:BRA"		
bramshaw.gov.uk	"local-authority-eng:NEW"		
breamore.gov.uk	"local-authority-eng:NEW"		
breckland.gov.uk	"local-authority-eng:BRE"		
breckland-sholland.gov.uk	"local-authority-eng:BRE"		
brentwood.gov.uk	"local-authority-eng:BRW"		
bristol-city.gov.uk	"local-authority-eng:BST"		
bristol.gov.uk	"local-authority-eng:BST"		
broadland.gov.uk	"local-authority-eng:BRO"		
brockenhurst.gov.uk	"local-authority-eng:NEW"		
bromley.gov.uk	"local-authority-eng:BRY"		
bromsgroveandredditch.gov.uk	"local-authority-eng:BRM"		
bromsgrove.gov.uk	"local-authority-eng:BRM"		
broxbourne.gov.uk	"local-authority-eng:BRX"		
broxtowe.gov.uk	"local-authority-eng:BRT"		
buckinghamshirepartnership.gov.uk	"local-authority-eng:BKM"		
bucksalc.gov.uk	"local-authority-eng:BKM"		
bucksandsurreytradingstandards.gov.uk	"local-authority-eng:SRY"		
buckscc.gov.uk	"local-authority-eng:BKM"		
buckshomechoice.gov.uk	"local-authority-eng:AYL"		
buildingcontrolpartnershiphants.gov.uk	"local-authority-eng:FAR"		
burleyparishcouncil.gov.uk	"local-authority-eng:NEW"		
burnley.gov.uk	"local-authority-eng:BUN"		
bury.gov.uk	"local-authority-eng:BUR"		
burystedmunds-tc.gov.uk	"local-authority-eng:SED"		
businessadviceday.gov.uk	"government-organisation:D25"		
cac.gov.uk	"government-organisation:D1198"		
cainscross-pc.gov.uk	"local-authority-eng:STO"		
calderdale.gov.uk	"local-authority-eng:CLD"		
cambridge.gov.uk	"local-authority-eng:CAB"		
cambridgeshire.gov.uk	"local-authority-eng:CAM"		
campaign.gov.uk	"government-organisation:OT1056"		
cannockchasedc.gov.uk	"local-authority-eng:CAN"		
canterbury.gov.uk	"local-authority-eng:CAT"		
capel-pc.gov.uk	"local-authority-eng:MOL"		
carestandardstribunal.gov.uk	"government-organisation:D12"		
caretribunalni.gov.uk	"government-organisation:D12"		
carlisle.gov.uk	"local-authority-eng:CAR"		
carrierbagchargewales.gov.uk	"government-organisation:DA1019"		
castlepoint.gov.uk	"local-authority-eng:CAS"		
ccrc.gov.uk	"government-organisation:IM320"		
census.gov.uk	"government-organisation:D303"		
centralbedfordshire.gov.uk	"local-authority-eng:CBF"		
centrallondonforward.gov.uk	"local-authority-eng:LND"		
cffdl-cymru.gov.uk	"government-organisation:DA1019"		
chalford-pc.gov.uk	"local-authority-eng:STO"		
charnwood.gov.uk	"local-authority-eng:CHA"		
chelmsford.gov.uk	"local-authority-eng:CHL"		
cheltenham.gov.uk	"local-authority-eng:CHT"		
cherwellandsouthnorthants.gov.uk	"local-authority-eng:SNR"		
cherwell-dc.gov.uk	"local-authority-eng:CHR"		
cherwell.gov.uk	"local-authority-eng:CHR"		
cheshireeast.gov.uk	"local-authority-eng:CHE"		
cheshire.gov.uk	"local-authority-eng:CHW"		
cheshireprepared.gov.uk	"local-authority-eng:CHW"		
cheshirewestandchester.gov.uk	"local-authority-eng:CHW"		
cheshirewest.gov.uk	"local-authority-eng:CHW"		
chesterfield.gov.uk	"local-authority-eng:CHS"		
chester.gov.uk	"local-authority-eng:CHW"		
chichester.gov.uk	"local-authority-eng:CHI"		
childcarechoices.gov.uk	"government-organisation:D25"		
childtrustfund.gov.uk	"government-organisation:D25"		
chiltern.gov.uk	"local-authority-eng:CHN"		
chorley.gov.uk	"local-authority-eng:CHO"		
christchurchandeastdorset.gov.uk	"local-authority-eng:CHC"		
christchurch.gov.uk	"local-authority-eng:CHC"		
churchaston-pc.gov.uk	"local-authority-eng:TFW"		
chwaraedysgutyfucymru.gov.uk	"government-organisation:DA1019"		
cica.gov.uk	"government-organisation:PB297"		
cicap.gov.uk	"government-organisation:PB297"		
cicreg.gov.uk	"government-organisation:D1198"		
cicregulator.gov.uk	"government-organisation:D1198"		
cityoflondon.gov.uk	"local-authority-eng:LND"		
civilappeals.gov.uk	"government-organisation:D18"		
cjit.gov.uk	"government-organisation:D18"		
cjs.gov.uk	"government-organisation:D18"		
cjsonline.gov.uk	"government-organisation:D18"		
claimsregulation.gov.uk	"government-organisation:D18"		
cma.gov.uk	"government-organisation:D550"		
coal.gov.uk	"government-organisation:D1198"		
coastalwight.gov.uk	"local-authority-eng:IOW"		
cofrestrfatir.gov.uk	"government-organisation:D69"		
colchester.gov.uk	"local-authority-eng:COL"		
comffin-cymru.gov.uk	"government-organisation:DA1019"		
communities.gov.uk	"government-organisation:D4"		
companies-house.gov.uk	"government-organisation:EA26"		
companieshouse.gov.uk	"government-organisation:EA26"		
copelandbc.gov.uk	"local-authority-eng:COP"		
copeland.gov.uk	"local-authority-eng:COP"		
corby.gov.uk	"local-authority-eng:COR"		
cornwall-aonb.gov.uk	"local-authority-eng:CON"		
cornwall.gov.uk	"local-authority-eng:CON"		
corpoflondon.gov.uk	"local-authority-eng:LND"		
corporationoflondon.gov.uk	"local-authority-eng:LND"		
cotswold.gov.uk	"local-authority-eng:COT"		
counter-eavesdropping.gov.uk	"government-organisation:D13"		
courtfunds.gov.uk	"government-organisation:D18"		
courts.gov.uk	"government-organisation:D18"		
coventry.gov.uk	"local-authority-eng:COV"		
cpni.gov.uk	"government-organisation:OT567"		
cps.gov.uk	"government-organisation:D101"		
cravendc.gov.uk	"local-authority-eng:CRA"		
crawley.gov.uk	"local-authority-eng:CRW"		
crb.gov.uk	"government-organisation:OT726"		
crbonline.gov.uk	"government-organisation:PB509"		
criminal-justice-system.gov.uk	"government-organisation:D18"		
crowncommercial.gov.uk	"government-organisation:EA1015"		
croydon.gov.uk	"local-authority-eng:CRY"		
csirtuk.gov.uk	"government-organisation:OT567"		
csr.gov.uk	"government-organisation:D1198"		
cst.gov.uk	"government-organisation:PB121"		
culturalpropertyadvice.gov.uk	"government-organisation:PB165"		
cumbriacc.gov.uk	"local-authority-eng:CMA"		
cumbriafire.gov.uk	"local-authority-eng:CMA"		
cumbria.gov.uk	"local-authority-eng:CMA"		
cyberaware.gov.uk	"government-organisation:D16"		
cyfoethnaturiolcymru.gov.uk	"government-organisation:DA1019"		
cyfrifiad.gov.uk	"government-organisation:D303"		
cymru.gov.uk	"government-organisation:DA1019"		
cymrugydnerth.gov.uk	"government-organisation:DA1019"		
cymruoltroedcarbon.gov.uk	"government-organisation:DA1019"		
cymru-wales.gov.uk	"government-organisation:DA1019"		
dacorum.gov.uk	"local-authority-eng:DAC"		
darlington.gov.uk	"local-authority-eng:DAL"		
dartford.gov.uk	"local-authority-eng:DAR"		
dartmoor.gov.uk	"government-organisation:OT217"		
dartmoor-npa.gov.uk	"government-organisation:OT217"		
daventrydc.gov.uk	"local-authority-eng:DAV"		
dbs.gov.uk	"government-organisation:PB509"		
dca.gov.uk	"government-organisation:D18"		
dclg.gov.uk	"government-organisation:D4"		
dcsf.gov.uk	"government-organisation:D6"		
derby.gov.uk	"local-authority-eng:DER"		
derbyshiredales.gov.uk	"local-authority-eng:DEB"		
derbyshire.gov.uk	"local-authority-eng:DBY"		
derbyshirepartnership.gov.uk	"local-authority-eng:DBY"		
devonaudit.gov.uk	"local-authority-eng:DEV"		
devonebiz.gov.uk	"local-authority-eng:DEV"		
devon.gov.uk	"local-authority-eng:DEV"		
devonjobs.gov.uk	"local-authority-eng:DEV"		
dfes.gov.uk	"government-organisation:D6"		
dfid.gov.uk	"government-organisation:D8"		
dft.gov.uk	"government-organisation:D9"		
dh.gov.uk	"government-organisation:D12"		
dhsspsni.gov.uk	"government-organisation:D12"		
digitv.gov.uk	"local-authority-eng:KIR"		
disability.gov.uk	"government-organisation:D10"		
doh.gov.uk	"government-organisation:D12"		
dojni.gov.uk	"government-organisation:D19"		
doncaster.gov.uk	"local-authority-eng:DNC"		
dorsetcc.gov.uk	"local-authority-eng:DOR"		
dorsetforyou.gov.uk	"local-authority-eng:WEY"		
dorset.gov.uk	"local-authority-eng:WDO"		
dorsetwastepartnership.gov.uk	"local-authority-eng:DOR"		
dover.gov.uk	"local-authority-eng:DOV"		
dppni.gov.uk	"government-organisation:D101"		
drugs.gov.uk	"government-organisation:D16"		
dsa.gov.uk	"government-organisation:EA75"		
dss.gov.uk	"government-organisation:D10"		
dstl.gov.uk	"government-organisation:EA42"		
dti.gov.uk	"government-organisation:D1198"		
dudley.gov.uk	"local-authority-eng:DUD"		
durhamcity.gov.uk	"local-authority-eng:DUR"		
durham.gov.uk	"local-authority-eng:DUR"		
dvla.gov.uk	"government-organisation:EA74"		
dvlaonline.gov.uk	"government-organisation:EA74"		
dwp.gov.uk	"government-organisation:D10"		
eastbourne.gov.uk	"local-authority-eng:EAS"		
eastcambs.gov.uk	"local-authority-eng:ECA"		
eastdevon.gov.uk	"local-authority-eng:EDE"		
eastdorsetdc.gov.uk	"local-authority-eng:EDO"		
eastdorset.gov.uk	"local-authority-eng:EDO"		
easthants.gov.uk	"local-authority-eng:EHA"		
eastkent.gov.uk	"local-authority-eng:THA"		
eastleigh.gov.uk	"local-authority-eng:EAT"		
eastlindsey.gov.uk	"local-authority-eng:ELI"		
east-northamptonshire.gov.uk	"local-authority-eng:ENO"		
eastriding.gov.uk	"local-authority-eng:ERY"		
eaststaffsbc.gov.uk	"local-authority-eng:EST"		
eastsuffolk.gov.uk	"local-authority-eng:WAV"		
eastsussexcc.gov.uk	"local-authority-eng:ESX"		
eastsussex.gov.uk	"local-authority-eng:ESX"		
eatsafe.gov.uk	"government-organisation:D102"		
e-chorley.gov.uk	"local-authority-eng:CHO"		
eden.gov.uk	"local-authority-eng:EDN"		
edinburgh.gov.uk	"local-authority-sct:EDH"		
education.gov.uk	"government-organisation:D6"		
eforestry.gov.uk	"government-organisation:D85"		
eidcymru.gov.uk	"government-organisation:DA1019"		
eldc.gov.uk	"local-authority-eng:ELI"		
e-lindsey.gov.uk	"local-authority-eng:ELI"		
elmbridge.gov.uk	"local-authority-eng:ELM"		
emergencynorthyorks.gov.uk	"local-authority-eng:NYK"		
emetaskforce.gov.uk	"government-organisation:D10"		
employmentappeals.gov.uk	"government-organisation:D18"		
employmenttribunals.gov.uk	"government-organisation:D18"		
encor.gov.uk	"local-authority-eng:COR"		
environment-agency.gov.uk	"government-organisation:EA199"		
eppingforestdc.gov.uk	"local-authority-eng:EPP"		
epsom-ewell.gov.uk	"local-authority-eng:EPS"		
equalities.gov.uk	"government-organisation:D10"		
erewash.gov.uk	"local-authority-eng:ERE"		
esf.gov.uk	"government-organisation:D10"		
essexcc.gov.uk	"local-authority-eng:ESS"		
essex.gov.uk	"local-authority-eng:ESS"		
essexlegalservices.gov.uk	"local-authority-eng:ESS"		
estyn.gov.uk	"government-organisation:DA1105"		
europeansocialfund.gov.uk	"government-organisation:D10"		
exchange.gov.uk	"government-organisation:OT610"		
exeterandeastdevon.gov.uk	"local-authority-eng:EDE"		
exeter.gov.uk	"local-authority-eng:EXE"		
exmoor-nationalpark.gov.uk	"government-organisation:OT219"		
exmoor-npa.gov.uk	"government-organisation:OT219"		
fareham.gov.uk	"local-authority-eng:FAR"		
fco.gov.uk	"government-organisation:D13"		
fcoservices.gov.uk	"government-organisation:D13"		
fcos.gov.uk	"government-organisation:D13"		
fenland.gov.uk	"local-authority-eng:FEN"		
fennycompton-pc.gov.uk	"local-authority-eng:STR"		
fernhurst-wsx-pc.gov.uk	"local-authority-eng:CHI"		
financeandtaxtribunals.gov.uk	"government-organisation:D18"		
financialsectorcontinuity.gov.uk	"government-organisation:D15"		
fire.gov.uk	"government-organisation:D16"		
firekills.gov.uk	"government-organisation:D16"		
fishbourne-pc.gov.uk	"local-authority-eng:CHI"		
flamborough-pc.gov.uk	"local-authority-eng:ERY"		
folkestone-tc.gov.uk	"local-authority-eng:SHE"		
food.gov.uk	"government-organisation:D102"		
foodstandards.gov.uk	"government-organisation:D102"		
fordingbridge.gov.uk	"local-authority-eng:NEW"		
foresight.gov.uk	"government-organisation:D1198"		
forest-heath.gov.uk	"local-authority-eng:SED"		
forestresearch.gov.uk	"government-organisation:D85"		
forestry.gov.uk	"government-organisation:D85"		
fsa.gov.uk	"government-organisation:OT1085"		
fylde.gov.uk	"local-authority-eng:FYL"		
gad.gov.uk	"government-organisation:D103"		
gamblingcommission.gov.uk	"government-organisation:PB169"		
gateshead.gov.uk	"local-authority-eng:GAT"		
gateway.gov.uk	"government-organisation:D25"		
gcccymru.gov.uk	"government-organisation:DA1019"		
gcs.gov.uk	"government-organisation:D9"		
gedling.gov.uk	"local-authority-eng:GED"		
generalcommissioners.gov.uk	"government-organisation:D18"		
ges.gov.uk	"government-organisation:D15"		
getingofar.gov.uk	"government-organisation:EA86"		
gloscc.gov.uk	"local-authority-eng:GLS"		
gloucester.gov.uk	"local-authority-eng:GLO"		
gloucestershire.gov.uk	"local-authority-eng:GLS"		
gls.gov.uk	"government-organisation:OT1033"		
godalming-tc.gov.uk	"local-authority-eng:WAE"		
gosport.gov.uk	"local-authority-eng:GOS"		
governmentlegal.gov.uk	"government-organisation:D1108"		
gpn.gov.uk	"government-organisation:D2"		
gravesham.gov.uk	"local-authority-eng:GRA"		
greatalne-pc.gov.uk	"local-authority-eng:STR"		
greatbusiness.gov.uk	"government-organisation:D1198"		
great-yarmouth.gov.uk	"local-authority-eng:GRY"		
gro.gov.uk	"government-organisation:EA66"		
gro-scotland.gov.uk	"government-organisation:OT1075"		
gsr.gov.uk	"government-organisation:D15"		
guardianship.gov.uk	"government-organisation:EA72"		
guildford.gov.uk	"local-authority-eng:GRT"		
gwerthwchigymru.gov.uk	"government-organisation:DA1019"		
hadleycentre.gov.uk	"government-organisation:EA46"		
halton-borough.gov.uk	"local-authority-eng:HAL"		
halton.gov.uk	"local-authority-eng:HAL"		
hambleton.gov.uk	"local-authority-eng:HAE"		
hampshire.gov.uk	"local-authority-eng:HAM"		
hantsdirect.gov.uk	"local-authority-eng:HAM"		
hantsfire.gov.uk	"local-authority-eng:HAM"		
hants.gov.uk	"local-authority-eng:HAM"		
hantsiowcaddie.gov.uk	"local-authority-eng:HAM"		
hantsnet.gov.uk	"local-authority-eng:HAM"		
hantsweb.gov.uk	"local-authority-eng:HAM"		
harborough.gov.uk	"local-authority-eng:HAO"		
harlow.gov.uk	"local-authority-eng:HAR"		
harrogate.gov.uk	"local-authority-eng:HAG"		
hart.gov.uk	"local-authority-eng:HAM"		
hartlepool.gov.uk	"local-authority-eng:HPL"		
hastings.gov.uk	"local-authority-eng:HAS"		
hatfield.gov.uk	"local-authority-eng:WEW"		
headley-pc.gov.uk	"local-authority-eng:MOL"		
healthestatesni.gov.uk	"government-organisation:D611"		
helptobuy.gov.uk	"government-organisation:D4"		
henley-in-arden-pc.gov.uk	"local-authority-eng:STR"		
heps.gov.uk	"local-authority-eng:ERY"		
herefordshire.gov.uk	"local-authority-eng:HEF"		
hertfordshire.gov.uk	"local-authority-eng:HRT"		
hertscc.gov.uk	"local-authority-eng:HRT"		
hertsfire.gov.uk	"local-authority-eng:HRT"		
hertsmere.gov.uk	"local-authority-eng:HER"		
hfea.gov.uk	"government-organisation:D12"		
highland.gov.uk	"local-authority-sct:HLD"		
highpeak.gov.uk	"local-authority-eng:HIG"		
hillingdon.gov.uk	"local-authority-eng:HIL"		
hiow.gov.uk	"local-authority-eng:HAM"		
hmce.gov.uk	"government-organisation:D25"		
hmgcc.gov.uk	"government-organisation:D16"		
hmiprisons.gov.uk	"government-organisation:D18"		
hmiprobation.gov.uk	"government-organisation:D18"		
hmprisonservice.gov.uk	"government-organisation:EA321"		
hmrc.gov.uk	"government-organisation:D25"		
hmrevenueandcustoms.gov.uk	"government-organisation:D25"		
hmrevenue-customs.gov.uk	"government-organisation:D25"		
hmt.gov.uk	"government-organisation:D15"		
hm-treasury.gov.uk	"government-organisation:D15"		
holmwood-pc.gov.uk	"local-authority-eng:MOL"		
homeoffice.gov.uk	"government-organisation:D16"		
horsham.gov.uk	"local-authority-eng:HOR"		
hounslow.gov.uk	"local-authority-eng:HNS"		
hse.gov.uk	"government-organisation:PB207"		
humberlrf.gov.uk	"local-authority-eng:ERY"		
huntingdonshire.gov.uk	"local-authority-eng:HUN"		
huntsdc.gov.uk	"local-authority-eng:HUN"		
hyde-pc.gov.uk	"local-authority-eng:NEW"		
hyndburnbc.gov.uk	"local-authority-eng:HYN"		
hyndburn.gov.uk	"local-authority-eng:HYN"		
hytheanddibden.gov.uk	"local-authority-eng:NEW"		
identityandpassportservice.gov.uk	"government-organisation:D16"		
imagesofdisability.gov.uk	"government-organisation:D10"		
immigrationservicestribunal.gov.uk	"government-organisation:D18"		
informationtribunal.gov.uk	"government-organisation:D18"		
inlandrevenue.gov.uk	"government-organisation:D25"		
inrev.gov.uk	"government-organisation:D25"		
iow.gov.uk	"local-authority-eng:IOW"		
ipcc.gov.uk	"government-organisation:PB456"		
ips.gov.uk	"government-organisation:PB265"		
ipswich.gov.uk	"local-authority-eng:IPS"		
iragentreg.gov.uk	"government-organisation:D25"		
ir-efile.gov.uk	"government-organisation:D25"		
ir.gov.uk	"government-organisation:D25"		
ir-online.gov.uk	"government-organisation:D25"		
islington.gov.uk	"local-authority-eng:ISL"		
jncc.gov.uk	"government-organisation:PB201"		
jobcentreplus.gov.uk	"government-organisation:D10"		
jobsandskills.gov.uk	"government-organisation:D10"		
judicialappointments.gov.uk	"government-organisation:D18"		
judiciary.gov.uk	"government-organisation:D18"		
justice.gov.uk	"government-organisation:D18"		
kentconnects.gov.uk	"local-authority-eng:KEN"		
kent.gov.uk	"local-authority-eng:KEN"		
kentparishes.gov.uk	"local-authority-eng:KEN"		
kerrier.gov.uk	"local-authority-eng:CON"		
kettering.gov.uk	"local-authority-eng:KET"		
kingston.gov.uk	"local-authority-eng:KTT"		
kirklees.gov.uk	"local-authority-eng:KIR"		
knowsley.gov.uk	"local-authority-eng:KWL"		
lake-district.gov.uk	"government-organisation:OT220"		
lakedistrict.gov.uk	"government-organisation:OT220"		
lancashire.gov.uk	"local-authority-eng:LAN"		
lancasterhouse.gov.uk	"government-organisation:D13"		
landregistry.gov.uk	"government-organisation:D69"		
landstribunal.gov.uk	"government-organisation:D18"		
lawcom.gov.uk	"government-organisation:D18"		
lawcommission.gov.uk	"government-organisation:D18"		
lawhf.gov.uk	"local-authority-eng:TFW"		
lawleyoverdale-pc.gov.uk	"local-authority-eng:TFW"		
ldbc-wales.gov.uk	"government-organisation:DA1019"		
leeds.gov.uk	"local-authority-eng:LDS"		
legalservices.gov.uk	"government-organisation:PB300"		
leicester.gov.uk	"local-authority-eng:LCE"		
leicestershire-fire.gov.uk	"local-authority-eng:LEC"		
leicestershire.gov.uk	"local-authority-eng:LEC"		
leics.gov.uk	"local-authority-eng:LEC"		
lewes-eastbourne.gov.uk	"local-authority-eng:EAS"		
lewes.gov.uk	"local-authority-eng:LEE"		
lewisham.gov.uk	"local-authority-eng:LEW"		
lichfielddc.gov.uk	"local-authority-eng:LIF"		
lifeintheuktest.gov.uk	"government-organisation:D16"		
lincolnshire.gov.uk	"local-authority-eng:LIN"		
lincsbc.gov.uk	"local-authority-eng:ELI"		
littlechalfontparishcouncil.gov.uk	"local-authority-eng:CHN"		
littlechalfont-pc.gov.uk	"local-authority-eng:CHN"		
liverpoolcityregion-ca.gov.uk	"local-authority-eng:KWL"		
liverpool.gov.uk	"local-authority-eng:LIV"		
lma.gov.uk	"local-authority-eng:LND"		
london.gov.uk	"local-authority-eng:GLA"		
londonpsn.gov.uk	"local-authority-eng:KTT"		
longcompton-pc.gov.uk	"local-authority-eng:STR"		
lookinglocal.gov.uk	"local-authority-eng:KIR"		
lowpay.gov.uk	"government-organisation:D1198"		
lsc.gov.uk	"government-organisation:EA86"		
luton.gov.uk	"local-authority-eng:LUT"		
maib.gov.uk	"government-organisation:D9"		
maiden.gov.uk	"local-authority-eng:GLS"		
maidenhead.gov.uk	"local-authority-eng:WNM"		
maidstone.gov.uk	"local-authority-eng:MAI"		
major-hazards.gov.uk	"government-organisation:PB207"		
maldon.gov.uk	"local-authority-eng:MAL"		
malvernhills.gov.uk	"local-authority-eng:MAV"		
manchester.gov.uk	"local-authority-eng:MAN"		
mansfield-dc.gov.uk	"local-authority-eng:MAS"		
mansfield.gov.uk	"local-authority-eng:MAS"		
marketweightontowncouncil.gov.uk	"local-authority-eng:ERY"		
marriages.gov.uk	"government-organisation:EA66"		
marstonsicca-pc.gov.uk	"local-authority-eng:STR"		
medway.gov.uk	"local-authority-eng:MDW"		
melton.gov.uk	"local-authority-eng:MEL"		
mendip.gov.uk	"local-authority-eng:MEN"		
merton.gov.uk	"local-authority-eng:MRT"		
met-office.gov.uk	"government-organisation:EA46"		
metoffice.gov.uk	"government-organisation:EA46"		
meto.gov.uk	"government-organisation:EA46"		
metweather.gov.uk	"government-organisation:EA46"		
mi6careers.gov.uk	"government-organisation:OT305"		
mi6.gov.uk	"government-organisation:OT305"		
middevon.gov.uk	"local-authority-eng:MDE"		
midkent.gov.uk	"local-authority-eng:SWL"		
midsuffolk.gov.uk	"local-authority-eng:MSU"		
midsussex.gov.uk	"local-authority-eng:MSS"		
milland-wsx-pc.gov.uk	"local-authority-eng:CHI"		
milton-keynes.gov.uk	"local-authority-eng:MIK"		
miltonkeynes.gov.uk	"local-authority-eng:MIK"		
minstead.gov.uk	"local-authority-eng:NEW"		
mmc.gov.uk	"government-organisation:PB353"		
mod.gov.uk	"government-organisation:D17"		
mole-valley.gov.uk	"local-authority-eng:MOL"		
molevalley.gov.uk	"local-authority-eng:MOL"		
moneyclaim.gov.uk	"government-organisation:D18"		
monitor.gov.uk	"government-organisation:PB255"		
monitor-nhsft.gov.uk	"government-organisation:PB255"		
mycounciltax.gov.uk	"government-organisation:D25"		
mynottingham.gov.uk	"local-authority-eng:NGM"		
myoxfordshire.gov.uk	"local-authority-eng:OXF"		
mysummaryvaluation.gov.uk	"government-organisation:D25"		
nactso.gov.uk	"government-organisation:OT1089"		
nafn.gov.uk	"local-authority-eng:TAM"		
nationalarchives.gov.uk	"government-organisation:EA71"		
nationalparks.gov.uk	"government-organisation:OT545"		
nationalrecordsofscotland.gov.uk	"government-organisation:OT1075"		
nationalrecordsscotland.gov.uk	"government-organisation:OT1075"		
natlotcomm.gov.uk	"government-organisation:PB169"		
naturalengland.gov.uk	"government-organisation:PB202"		
naturalresourceswales.gov.uk	"government-organisation:DA1019"		
nda.gov.uk	"government-organisation:PB197"		
ne-derbyshire.gov.uk	"local-authority-eng:NED"		
ne-ifca.gov.uk	"local-authority-eng:ERY"		
nelincs.gov.uk	"local-authority-eng:NEL"		
nen.gov.uk	"government-organisation:D6"		
netleymarsh-pc.gov.uk	"local-authority-eng:NEW"		
newforestcouncil.gov.uk	"local-authority-eng:NEW"		
newforestdc.gov.uk	"local-authority-eng:NEW"		
newforestdistrict.gov.uk	"local-authority-eng:NEW"		
newforest.gov.uk	"local-authority-eng:NEW"		
newham.gov.uk	"local-authority-eng:NWM"		
newmiltontowncouncil.gov.uk	"local-authority-eng:NEW"		
nfdc.gov.uk	"local-authority-eng:NEW"		
nhsft-regulator.gov.uk	"government-organisation:PB255"		
niauditoffice.gov.uk	"government-organisation:OT634"		
nic.gov.uk	"government-organisation:D15"		
nihe.gov.uk	"government-organisation:PB1212"		
nijac.gov.uk	"government-organisation:OT880"		
nimdta.gov.uk	"government-organisation:D12"		
nio.gov.uk	"government-organisation:D19"		
niprisonservice.gov.uk	"government-organisation:EA797"		
nisra.gov.uk	"government-organisation:EA701"		
nisranet.gov.uk	"government-organisation:EA701"		
nissa.gov.uk	"government-organisation:EA675"		
n-kesteven.gov.uk	"local-authority-eng:NKE"		
nmo.gov.uk	"government-organisation:EA1109"		
nmro.gov.uk	"government-organisation:EA1109"		
norfolkedunet.gov.uk	"local-authority-eng:NFK"		
norfolkfireservice.gov.uk	"local-authority-eng:NFK"		
norfolk.gov.uk	"local-authority-eng:NFK"		
norfolkparishes.gov.uk	"local-authority-eng:NFK"		
norfolkprepared.gov.uk	"local-authority-eng:NFK"		
northampton.gov.uk	"local-authority-eng:NOR"		
northamptonshire.gov.uk	"local-authority-eng:NTH"		
northants-ecl.gov.uk	"local-authority-eng:NTH"		
northantslicensing.gov.uk	"local-authority-eng:ENO"		
north-dorset.gov.uk	"local-authority-eng:NDO"		
northeast-tadu.gov.uk	"local-authority-eng:GAT"		
northernpowerhouse.gov.uk	"government-organisation:D4"		
north-herts.gov.uk	"local-authority-eng:NHE"		
northlincs.gov.uk	"local-authority-eng:NLN"		
north-norfolk.gov.uk	"local-authority-eng:NNO"		
northumberland.gov.uk	"local-authority-eng:NBL"		
northwarks.gov.uk	"local-authority-eng:NWA"		
northwestvotes.gov.uk	"local-authority-eng:MAN"		
northyorks.gov.uk	"local-authority-eng:NYK"		
norwich.gov.uk	"local-authority-eng:NOW"		
nottinghamcity.gov.uk	"local-authority-eng:NGM"		
nottingham.gov.uk	"local-authority-eng:NGM"		
nottinghamshire.gov.uk	"local-authority-eng:NTT"		
nottscc.gov.uk	"local-authority-eng:NTT"		
npswales.gov.uk	"government-organisation:DA1019"		
nrscotland.gov.uk	"government-organisation:OT1075"		
nsgi.gov.uk	"government-organisation:D17"		
nuneatonandbedworth.gov.uk	"local-authority-eng:NUN"		
nwleicestershire.gov.uk	"local-authority-eng:NWL"		
nwleicsdc.gov.uk	"local-authority-eng:NWL"		
nwleics.gov.uk	"local-authority-eng:NWL"		
nwml.gov.uk	"government-organisation:OT712"		
oadby-wigston.gov.uk	"local-authority-eng:OAD"		
oag.gov.uk	"government-organisation:D23"		
oakengates-tc.gov.uk	"local-authority-eng:TFW"		
odi.gov.uk	"government-organisation:D10"		
officefordisability.gov.uk	"government-organisation:D10"		
oft.gov.uk	"government-organisation:D352"		
oisc.gov.uk	"government-organisation:PB263"		
oldham.gov.uk	"local-authority-eng:OLD"		
onr.gov.uk	"government-organisation:D10"		
ons.gov.uk	"government-organisation:D303"		
openaccess.gov.uk	"government-organisation:PB202"		
operational-research.gov.uk	"government-organisation:OT1042"		
orkney.gov.uk	"local-authority-sct:ORK"		
orr.gov.uk	"government-organisation:D110"		
osni.gov.uk	"government-organisation:EA695"		
osscsc.gov.uk	"government-organisation:D18"		
otc.gov.uk	"government-organisation:EA74"		
ownyourhome.gov.uk	"government-organisation:D4"		
oxford.gov.uk	"local-authority-eng:OXO"		
oxfordshire.gov.uk	"local-authority-eng:OXF"		
oxfordshire-online.gov.uk	"local-authority-eng:OXF"		
oxfordshireonline.gov.uk	"local-authority-eng:OXF"		
oxon.gov.uk	"local-authority-eng:OXF"		
paessex.gov.uk	"local-authority-eng:ESS"		
peakdistrict.gov.uk	"government-organisation:OT545"		
pendle.gov.uk	"local-authority-eng:PEN"		
pensionregulator.gov.uk	"government-organisation:PB234"		
pensionsappealtribunals.gov.uk	"government-organisation:D18"		
pensionsatwork.gov.uk	"government-organisation:D10"		
pensionservice.gov.uk	"government-organisation:D10"		
pensions.gov.uk	"government-organisation:D10"		
pensionsregulator.gov.uk	"government-organisation:PB234"		
pensionsservice.gov.uk	"government-organisation:D10"		
pensionwise.gov.uk	"government-organisation:D15"		
peoplesnetwork.gov.uk	"government-organisation:PB165"		
peterborough.gov.uk	"local-authority-eng:PTE"		
phe.gov.uk	"government-organisation:EA480"		
pitchcombe-pc.gov.uk	"local-authority-eng:STO"		
planning-inspectorate.gov.uk	"government-organisation:EA39"		
planninginspectorate.gov.uk	"government-organisation:EA39"		
planningportal.gov.uk	"government-organisation:D4"		
plymouth.gov.uk	"local-authority-eng:PLY"		
plymouthmuseum.gov.uk	"local-authority-eng:PLY"		
pnn.gov.uk	"government-organisation:D16"		
poole.gov.uk	"local-authority-eng:POL"		
portsmouthcc.gov.uk	"local-authority-eng:POR"		
portsmouth.gov.uk	"local-authority-eng:POR"		
possessionclaim.gov.uk	"government-organisation:D18"		
ppo.gov.uk	"government-organisation:D18"		
ppsni.gov.uk	"government-organisation:D101"		
preston.gov.uk	"local-authority-eng:PRE"		
prisonandprobationjobs.gov.uk	"government-organisation:D18"		
publicguardian.gov.uk	"government-organisation:D18"		
purbeck-dc.gov.uk	"local-authority-eng:PUR"		
purbeck.gov.uk	"local-authority-eng:PUR"		
push.gov.uk	"local-authority-eng:HAM"		
raib.gov.uk	"government-organisation:D9"		
rail-reg.gov.uk	"government-organisation:D110"		
ratleyandupton-pc.gov.uk	"local-authority-eng:STR"		
rbwm.gov.uk	"local-authority-eng:WNM"		
reading.gov.uk	"local-authority-eng:RDG"		
redbridge.gov.uk	"local-authority-eng:RDB"		
redcar-cleveland.gov.uk	"local-authority-eng:RCC"		
redditchbc.gov.uk	"local-authority-eng:RED"		
reigate-banstead.gov.uk	"local-authority-eng:REI"		
respect.gov.uk	"government-organisation:D16"		
returninghome.gov.uk	"government-organisation:D16"		
revenueandcustoms.gov.uk	"government-organisation:D25"		
richmondandwandsworth.gov.uk	"local-authority-eng:WND"		
richmondshire.gov.uk	"local-authority-eng:RIH"		
riddor.gov.uk	"government-organisation:PB207"		
righttobuy.gov.uk	"government-organisation:D4"		
rochdale.gov.uk	"local-authority-eng:RCH"		
rochford.gov.uk	"local-authority-eng:ROC"		
rohs.gov.uk	"government-organisation:OT712"		
rossendalebc.gov.uk	"local-authority-eng:ROS"		
rossendale.gov.uk	"local-authority-eng:ROS"		
rother.gov.uk	"local-authority-eng:ROH"		
rpts.gov.uk	"government-organisation:D18"		
rugby.gov.uk	"local-authority-eng:RUG"		
runnymede.gov.uk	"local-authority-eng:RUN"		
rushcliffe.gov.uk	"local-authority-eng:RUS"		
rushmoor.gov.uk	"local-authority-eng:RUH"		
rutland.gov.uk	"local-authority-eng:RUT"		
ryedale.gov.uk	"local-authority-eng:RYE"		
sacn.gov.uk	"government-organisation:D12"		
saferderbyshire.gov.uk	"local-authority-eng:DBY"		
salford.gov.uk	"local-authority-eng:SLF"		
sandleheath.gov.uk	"local-authority-eng:NEW"		
sandwell.gov.uk	"local-authority-eng:SAW"		
scambs.gov.uk	"local-authority-eng:SCA"		
scarborough.gov.uk	"local-authority-eng:SCE"		
scilly.gov.uk	"local-authority-eng:IOS"		
scn.gov.uk	"government-organisation:D16"		
scotlandcensus.gov.uk	"government-organisation:OT1075"		
scotlandoffice.gov.uk	"government-organisation:D23"		
scotlandscensus.gov.uk	"government-organisation:OT1075"		
scotlandspeople.gov.uk	"government-organisation:OT1075"		
scotlandspeoplehub.gov.uk	"government-organisation:OT1075"		
scotlawcom.gov.uk	"government-organisation:OT612"		
secouncils.gov.uk	"local-authority-eng:SRY"		
secureyourfertiliser.gov.uk	"government-organisation:OT1089"		
sedgemoor.gov.uk	"local-authority-eng:SEG"		
sefton.gov.uk	"local-authority-eng:SFT"		
selby.gov.uk	"local-authority-eng:SEL"		
selbytowncouncil.gov.uk	"local-authority-eng:SEL"		
sell2wales.gov.uk	"government-organisation:DA1019"		
sentencingcouncil.gov.uk	"government-organisation:D18"		
sentencing-guidelines.gov.uk	"government-organisation:D16"		
sentw.gov.uk	"government-organisation:DA1019"		
sesplan.gov.uk	"local-authority-sct:EDH"		
sevenoaks.gov.uk	"local-authority-eng:SEV"		
sfo.gov.uk	"government-organisation:D115"		
shareholderexecutive.gov.uk	"government-organisation:D1198"		
sheffield.gov.uk	"local-authority-eng:SHF"		
shepway.gov.uk	"local-authority-eng:SHE"		
shetland.gov.uk	"local-authority-sct:ZET"		
shetland-library.gov.uk	"local-authority-sct:ZET"		
sholland.gov.uk	"local-authority-eng:SHO"		
shropshire.gov.uk	"local-authority-eng:SHR"		
sigoma.gov.uk	"local-authority-eng:BNS"		
silicone-review.gov.uk	"government-organisation:D12"		
siscareers.gov.uk	"government-organisation:OT305"		
sis.gov.uk	"government-organisation:OT305"		
slough.gov.uk	"local-authority-eng:SLG"		
soca.gov.uk	"government-organisation:PB265"		
solihull.gov.uk	"local-authority-eng:SOL"		
somerset.gov.uk	"local-authority-eng:SOM"		
sopley.gov.uk	"local-authority-eng:NEW"		
southampton.gov.uk	"local-authority-eng:STH"		
southandvale.gov.uk	"local-authority-eng:VAL"		
south-derbys.gov.uk	"local-authority-eng:SDE"		
southdowns.gov.uk	"government-organisation:OT546"		
southend.gov.uk	"local-authority-eng:SOS"		
southglos.gov.uk	"local-authority-eng:SGC"		
southgloucestershire.gov.uk	"local-authority-eng:SGC"		
south-hams-dc.gov.uk	"local-authority-eng:SHA"		
southhams.gov.uk	"local-authority-eng:SHA"		
southkesteven.gov.uk	"local-authority-eng:SKE"		
southlakeland.gov.uk	"local-authority-eng:SLA"		
southnorthants.gov.uk	"local-authority-eng:SNR"		
southoxon.gov.uk	"local-authority-eng:SOX"		
southribble.gov.uk	"local-authority-eng:SRI"		
southribbletourism.gov.uk	"local-authority-eng:SRI"		
southsomerset.gov.uk	"local-authority-eng:SSO"		
southtyneside.gov.uk	"local-authority-eng:STY"		
southwest-ra.gov.uk	"local-authority-eng:SOM"		
southworcestershirebuildingcontrol.gov.uk	"local-authority-eng:MAV"		
southworcestershirerevenues.gov.uk	"local-authority-eng:WYC"		
spelthorne.gov.uk	"local-authority-eng:SPE"		
ssani.gov.uk	"government-organisation:EA675"		
ssro.gov.uk	"government-organisation:PB1093"		
stabilisationunit.gov.uk	"government-organisation:OT1086"		
stabilizationunit.gov.uk	"government-organisation:OT1086"		
staffordbc.gov.uk	"local-authority-eng:STA"		
staffordshire.gov.uk	"local-authority-eng:STS"		
staffordshireprepared.gov.uk	"local-authority-eng:STS"		
staffs.gov.uk	"local-authority-eng:STS"		
staffslc.gov.uk	"local-authority-eng:STS"		
staffsmoorlands.gov.uk	"local-authority-eng:STF"		
star-procurement.gov.uk	"local-authority-eng:TRF"		
statisticsauthority.gov.uk	"government-organisation:D303"		
statistics.gov.uk	"government-organisation:D303"		
statutelaw.gov.uk	"government-organisation:D18"		
stedmundsbury.gov.uk	"local-authority-eng:SED"		
stedsbc.gov.uk	"local-authority-eng:SED"		
stevenage.gov.uk	"local-authority-eng:STV"		
stmarybourne-pc.gov.uk	"local-authority-eng:BAN"		
stockport.gov.uk	"local-authority-eng:SKP"		
stockportmbc.gov.uk	"local-authority-eng:SKP"		
stockton-bc.gov.uk	"local-authority-eng:STT"		
stockton.gov.uk	"local-authority-eng:STT"		
stockton-warks-pc.gov.uk	"local-authority-eng:STR"		
stoke.gov.uk	"local-authority-eng:STE"		
stoploansharks.gov.uk	"local-authority-eng:BIR"		
stourvalleypartnership.gov.uk	"local-authority-eng:POL"		
stratford-dc.gov.uk	"local-authority-eng:STR"		
stratford.gov.uk	"local-authority-eng:STR"		
stroud.gov.uk	"local-authority-eng:STO"		
s-tyneside-mbc.gov.uk	"local-authority-eng:STY"		
suffolkcc.gov.uk	"local-authority-eng:SFK"		
suffolkcoastal.gov.uk	"local-authority-eng:SFK"		
suffolk.gov.uk	"local-authority-eng:SFK"		
supportwithconfidence.gov.uk	"local-authority-eng:SRY"		
surreycc.gov.uk	"local-authority-eng:SRY"		
surreycoroner.gov.uk	"local-authority-eng:SRY"		
surreycountycouncil.gov.uk	"local-authority-eng:SRY"		
surrey-fire.gov.uk	"local-authority-eng:SRY"		
surreyfirst.gov.uk	"local-authority-eng:TAN"		
surrey.gov.uk	"local-authority-eng:SRY"		
surreyheath.gov.uk	"local-authority-eng:SUR"		
surreyheath-online.gov.uk	"local-authority-eng:SUR"		
surreyheathonline.gov.uk	"local-authority-eng:SUR"		
surreyi.gov.uk	"local-authority-eng:SRY"		
surreylocalgovernment.gov.uk	"local-authority-eng:WOI"		
surveillancecommissioners.gov.uk	"government-organisation:D16"		
sussexsaferroads.gov.uk	"local-authority-eng:WSX"		
swale.gov.uk	"local-authority-eng:SWL"		
sway-pc.gov.uk	"local-authority-eng:NEW"		
swdevon.gov.uk	"local-authority-eng:SHA"		
swindon.gov.uk	"local-authority-eng:SWD"		
taaac.gov.uk	"government-organisation:DA1019"		
taluamfagiaucymru.gov.uk	"government-organisation:DA1019"		
tameside.gov.uk	"local-authority-eng:TAM"		
tamworth.gov.uk	"local-authority-eng:TAW"		
tandridgedc.gov.uk	"local-authority-eng:TAN"		
tandridge.gov.uk	"local-authority-eng:TAN"		
targetingfraud.gov.uk	"government-organisation:D10"		
tartanregister.gov.uk	"government-organisation:OT1075"		
tauntondeane.gov.uk	"local-authority-eng:TAU"		
teesvalley-ca.gov.uk	"local-authority-eng:STT"		
teesvalleyunlimited.gov.uk	"local-authority-eng:STT"		
teignbridge.gov.uk	"local-authority-eng:TEI"		
telford.gov.uk	"local-authority-eng:TFW"		
tendringdc.gov.uk	"local-authority-eng:TEN"		
testvalley.gov.uk	"local-authority-eng:TES"		
tewkesburybc.gov.uk	"local-authority-eng:TEW"		
tewkesbury.gov.uk	"local-authority-eng:TEW"		
thanet.gov.uk	"local-authority-eng:THA"		
thecity.gov.uk	"local-authority-eng:LND"		
themet-office.gov.uk	"government-organisation:EA46"		
themetoffice.gov.uk	"government-organisation:EA46"		
thepensionregulator.gov.uk	"government-organisation:PB234"		
thepensionservice.gov.uk	"government-organisation:D10"		
thepensionservices.gov.uk	"government-organisation:D10"		
thepensionsregulator.gov.uk	"government-organisation:PB234"		
theukmetoffice.gov.uk	"government-organisation:EA46"		
threerivers.gov.uk	"local-authority-eng:THE"		
thurrockfostering.gov.uk	"local-authority-eng:THR"		
thurrock.gov.uk	"local-authority-eng:THR"		
torbay.gov.uk	"local-authority-eng:TOB"		
torridge.gov.uk	"local-authority-eng:TOR"		
tpr.gov.uk	"government-organisation:PB234"		
trafford.gov.uk	"local-authority-eng:TRF"		
traffordparishes.gov.uk	"local-authority-eng:TRF"		
transporttribunal.gov.uk	"government-organisation:D18"		
treasury-solicitor.gov.uk	"government-organisation:D1108"		
tribunalservice.gov.uk	"government-organisation:D18"		
tribunals.gov.uk	"government-organisation:D18"		
tribunalsservice.gov.uk	"government-organisation:D18"		
tsol.gov.uk	"government-organisation:D1108"		
tunbridgewells.gov.uk	"local-authority-eng:TUN"		
tyrcwmniau.gov.uk	"government-organisation:EA26"		
ukciu.gov.uk	"government-organisation:PB265"		
ukfi.gov.uk	"government-organisation:PC259"		
ukgi.gov.uk	"government-organisation:D15"		
ukinvest.gov.uk	"government-organisation:D611"		
ukmet-office.gov.uk	"government-organisation:EA46"		
ukmetoffice.gov.uk	"government-organisation:EA46"		
uksport.gov.uk	"government-organisation:PB185"		
ukti.gov.uk	"government-organisation:D1198"		
uktradeinvest.gov.uk	"government-organisation:D1198"		
ukvisas.gov.uk	"government-organisation:D16"		
uk-weather.gov.uk	"government-organisation:EA46"		
ukweather.gov.uk	"government-organisation:EA46"		
uptonstleonards-pc.gov.uk	"local-authority-eng:STO"		
uttlesford.gov.uk	"local-authority-eng:UTT"		
valuationtribunal.gov.uk	"government-organisation:PB375"		
valuation-tribunals.gov.uk	"government-organisation:D25"		
vca.gov.uk	"government-organisation:EA80"		
vca-pos.gov.uk	"government-organisation:EA80"		
visitsouthribble.gov.uk	"local-authority-eng:SRI"		
visitukheritage.gov.uk	"government-organisation:D25"		
voa.gov.uk	"government-organisation:D25"		
walescarbonfootprint.gov.uk	"government-organisation:DA1019"		
wales.gov.uk	"government-organisation:DA1019"		
walesresilience.gov.uk	"government-organisation:DA1019"		
walsall.gov.uk	"local-authority-eng:WLL"		
wandsworth.gov.uk	"local-authority-eng:WND"		
wao.gov.uk	"government-organisation:OT908"		
warp.gov.uk	"government-organisation:OT567"		
warrington.gov.uk	"local-authority-eng:WRT"		
warwick-dc.gov.uk	"local-authority-eng:WAW"		
warwickdc.gov.uk	"local-authority-eng:WAW"		
warwick.gov.uk	"local-authority-eng:WAW"		
warwickshire.gov.uk	"local-authority-eng:WAR"		
watford-council.gov.uk	"local-authority-eng:WAT"		
watford.gov.uk	"local-authority-eng:WAT"		
waveney.gov.uk	"local-authority-eng:WAV"		
waverley.gov.uk	"local-authority-eng:WAE"		
wealden.gov.uk	"local-authority-eng:WEA"		
weather.gov.uk	"government-organisation:EA46"		
welfordonavon-pc.gov.uk	"local-authority-eng:STR"		
welhat.gov.uk	"local-authority-eng:WEW"		
wellingborough.gov.uk	"local-authority-eng:WEL"		
welwyn.gov.uk	"local-authority-eng:WEW"		
westberks.gov.uk	"local-authority-eng:WBK"		
westcumbria.gov.uk	"local-authority-eng:ALL"		
westdevon.gov.uk	"local-authority-eng:WDE"		
westdorset-dc.gov.uk	"local-authority-eng:WDO"		
westdorset-weymouth.gov.uk	"local-authority-eng:WDO"		
west-lindsey.gov.uk	"local-authority-eng:WLI"		
westofengland-ca.gov.uk	"local-authority-eng:BST"		
westoxon.gov.uk	"local-authority-eng:WOX"		
westsomerset.gov.uk	"local-authority-eng:WSO"		
westsomersetonline.gov.uk	"local-authority-eng:WSO"		
westsuffolk.gov.uk	"local-authority-eng:SED"		
westsussex.gov.uk	"local-authority-eng:WSX"		
westwey.gov.uk	"local-authority-eng:WEY"		
weymouth.gov.uk	"local-authority-eng:WEY"		
whitehorsedc.gov.uk	"local-authority-eng:VAL"		
wigan.gov.uk	"local-authority-eng:WGN"		
wiganmbc.gov.uk	"local-authority-eng:WGN"		
winchester.gov.uk	"local-authority-eng:WIN"		
windsor.gov.uk	"local-authority-eng:WNM"		
wixford-pc.gov.uk	"local-authority-eng:STR"		
woking.gov.uk	"local-authority-eng:WOI"		
wokingham.gov.uk	"local-authority-eng:WOK"		
woottonwawen-pc.gov.uk	"local-authority-eng:STR"		
worcestershire.gov.uk	"local-authority-eng:WOR"		
worcestershirehub.gov.uk	"local-authority-eng:WOR"		
worcestershirets.gov.uk	"local-authority-eng:WOR"		
worcsregservices.gov.uk	"local-authority-eng:BRM"		
workandpensions.gov.uk	"government-organisation:D10"		
workplacepensions.gov.uk	"government-organisation:D10"		
world-weather.gov.uk	"government-organisation:EA46"		
worldweather.gov.uk	"government-organisation:EA46"		
worthing.gov.uk	"local-authority-eng:WOT"		
wsx-donnington-pc.gov.uk	"local-authority-eng:CHI"		
wychavon.gov.uk	"local-authority-eng:WYC"		
wycombe.gov.uk	"local-authority-eng:WYO"		
wyrebc.gov.uk	"local-authority-eng:WYR"		
wyreforestdc.gov.uk	"local-authority-eng:WYE"		
wyreforest.gov.uk	"local-authority-eng:WYE"		
yeovil.gov.uk	"local-authority-eng:SSO"		
ygwasanaethpensiwn.gov.uk	"government-organisation:D10"		
yjani.gov.uk	"government-organisation:D19"		
yjb.gov.uk	"government-organisation:D18"		
york.gov.uk	"local-authority-eng:YOR"		
youthjusticeagencyni.gov.uk	"government-organisation:D19"		
tmbc.gov.uk	"local-authority-eng:TON"		
richmond.gov.uk	"local-authority-eng:RIC"		
parolecommissionerni.gov.uk	"government-organisation:OT913"		
mhra.gov.uk	"government-organisation:EA63"		
yellowcard.gov.uk	"government-organisation:EA63"		
west-norfolk.gov.uk	"local-authority-eng:KIN"		
hinckley-bosworth.gov.uk	"local-authority-eng:HIN"		
great.gov.uk	"government-organisation:D1196"		
trade.gov.uk	"government-organisation:D1196"		
barrowbc.gov.uk	"local-authority-eng:BAR"		
dhssni.gov.uk	"government-organisation:OT1175"		
familysupportni.gov.uk	"government-organisation:OT1175"		
deni.gov.uk	"government-organisation:D585"		
decc.gov.uk	"government-organisation:D11"		
eca.gov.uk	"government-organisation:D11"		
culture.gov.uk	"government-organisation:D5"		
dcms.gov.uk	"government-organisation:D5"		
geo.gov.uk	"government-organisation:D5"		
ypla.gov.uk	"government-organisation:EA960"		
entrepreneurs.gov.uk	"government-organisation:D117"		
exportingisgreat.gov.uk	"government-organisation:D117"		
tradeinvest.gov.uk	"government-organisation:D117"		
cne-siar.gov.uk	"local-authority-sct:ELS"		
causeway.gov.uk	"government-organisation:D1073"		
compensationni.gov.uk	"government-organisation:D1073"		
fsni.gov.uk	"government-organisation:D1073"		
lsani.gov.uk	"government-organisation:D1073"		
octf.gov.uk	"government-organisation:D1073"		
cafcass.gov.uk	"government-organisation:D6"		
eti-ni.gov.uk	"government-organisation:D6"		
etini.gov.uk	"government-organisation:D6"		
digitac.gov.uk	"government-organisation:EA570"		
digitaltachograph.gov.uk	"government-organisation:EA570"		
tan.gov.uk	"government-organisation:EA570"		
transportoffice.gov.uk	"government-organisation:EA570"		
vosa.gov.uk	"government-organisation:EA570"		
brighton-hove.gov.uk	"local-authority-eng:BNH"		
newcastle-staffs.gov.uk	"local-authority-eng:NEC"		
fdean.gov.uk	"local-authority-eng:FOE"		
forestofdean.gov.uk	"local-authority-eng:FOE"		
bcms.gov.uk	"government-organisation:D7"		
darwin.gov.uk	"government-organisation:D7"		
defra.gov.uk	"government-organisation:D7"		
dwi.gov.uk	"government-organisation:D7"		
gds.gov.uk	"government-organisation:D7"		
gvs.gov.uk	"government-organisation:D7"		
huntinginquiry.gov.uk	"government-organisation:D7"		
maff.gov.uk	"government-organisation:D7"		
magic.gov.uk	"government-organisation:D7"		
mfa.gov.uk	"government-organisation:D7"		
rimnet.gov.uk	"government-organisation:D7"		
rpa.gov.uk	"government-organisation:D7"		
svs.gov.uk	"government-organisation:D7"		
vla.gov.uk	"government-organisation:D7"		
newark-sherwooddc.gov.uk	"local-authority-eng:NEA"		
aaib.gov.uk	"government-organisation:D9"		
dvsa.gov.uk	"government-organisation:D9"		
mcga.gov.uk	"government-organisation:D9"		
aberdeencityandshire-sdpa.gov.uk	"local-authority-sct:ABE"		
aberdeenshire.gov.uk	"local-authority-sct:ABD"		
adjudicators.gov.uk	"government-organisation:OT433"		
advocategeneral.gov.uk	"government-organisation:D20"		
afbini.gov.uk	"government-organisation:OT1178"		
angus.gov.uk	"local-authority-sct:ANS"		
appealserviceni.gov.uk	"government-organisation:OT1173"		
argyll-bute.gov.uk	"local-authority-sct:AGB"		
attorneygeneralni.gov.uk	"government-organisation:OT1179"		
ayrshire.gov.uk	"local-authority-sct:SAY"		
blackpool.gov.uk	"local-authority-eng:BPL"		
bracknell-forest.gov.uk	"local-authority-eng:BRC"		
centralscotland-vjb.gov.uk	"local-authority-sct:CLK"		
charity-commission.gov.uk	"government-organisation:D98"		
childrenscommissioner.gov.uk	"government-organisation:PB413"		
cityofworcester.gov.uk	"local-authority-eng:WOC"		
cncbuildingcontrol.gov.uk	"local-authority-eng:SNO"		
coronersni.gov.uk	"government-organisation:EA725"		
csl.gov.uk	"government-organisation:EA56"		
dab-vjb.gov.uk	"local-authority-sct:WDU"		
doeni.gov.uk	"government-organisation:D591"		
drdni.gov.uk	"government-organisation:OT1176"		
dumgal.gov.uk	"local-authority-sct:DGY"		
east-ayrshire.gov.uk	"local-authority-sct:EAY"		
eastdunbarton.gov.uk	"local-authority-sct:EDU"		
eastlothian.gov.uk	"local-authority-sct:ELN"		
falkirk-council.gov.uk	"local-authority-sct:FAL"		
fifefire.gov.uk	"local-authority-sct:FIF"		
havering.gov.uk	"local-authority-eng:HAV"		
highways.gov.uk	"government-organisation:EA77"		
homesengland.gov.uk	"government-organisation:PB161"		
inverclyde.gov.uk	"local-authority-sct:IVC"		
lhc.gov.uk	"government-organisation:EA835"		
middlesbrough.gov.uk	"local-authority-eng:MDB"		
midlothian.gov.uk	"local-authority-sct:MLN"		
newcastle.gov.uk	"local-authority-eng:NET"		
newforestnpa.gov.uk	"government-organisation:OT222"		
north-ayrshire.gov.uk	"local-authority-sct:NAY"		
northdevon.gov.uk	"local-authority-eng:NDE"		
northlanarkshire.gov.uk	"local-authority-sct:NLK"		
northsomerset.gov.uk	"local-authority-eng:NSM"		
number10.gov.uk	"government-organisation:OT532"		
paroleboard.gov.uk	"government-organisation:PB301"		
rbkc.gov.uk	"local-authority-eng:KEC"		
renfrewshire.gov.uk	"local-authority-sct:RFW"		
ribblevalley.gov.uk	"local-authority-eng:RIB"		
southlanarkshire.gov.uk	"local-authority-sct:SLK"		
sstaffs.gov.uk	"local-authority-eng:SST"		
stirling.gov.uk	"local-authority-sct:STG"		
tsb.gov.uk	"government-organisation:PB136"		
walesoffice.gov.uk	"government-organisation:OT590"		
westlothian.gov.uk	"local-authority-sct:WLN"		
wiltshire.gov.uk	"local-authority-eng:WIL"		
yorkconsort.gov.uk			
ynysmon.gov.uk			
yetminsterparishes.gov.uk			
yeovilwithoutparishcouncil.gov.uk			
yelvertoft-pc.gov.uk			
yaptonpc.gov.uk			
YaldingParishCouncil.gov.uk			
xhibit.gov.uk			
wyre.gov.uk			
wsm-tc.gov.uk			
wrwa.gov.uk			
wroseparishcouncil.gov.uk			
wringtonparishcouncil.gov.uk			
wrexham.gov.uk			
wrecsam.gov.uk			
wraysburyparishcouncil.gov.uk			
wraxallandfailand-pc.gov.uk			
worplesdon-pc.gov.uk			
workingtontowncouncil.gov.uk			
woolley-pc.gov.uk			
woodchurch-pc.gov.uk			
woodbridge-suffolk.gov.uk			
wooburnparish.gov.uk			
wolverhampton.gov.uk			
wokinghamwithout-pc.gov.uk			
wmortimerhazeleigh-pc.gov.uk			
wivenhoe.gov.uk			
witham.gov.uk			
witham-1st-idb.gov.uk			
wirral-mbc.gov.uk			
wirksworth.gov.uk			
winteringham-pc.gov.uk			
winsford.gov.uk			
winnersh.gov.uk			
wiltontowncouncil.gov.uk			
wilcotandhuish-pc.gov.uk			
wilbarstonparishcouncil.gov.uk			
whitnashtowncouncil.gov.uk			
whiteshillandruscombe-pc.gov.uk			
whitchurch-hampshire-tc.gov.uk			
WheatonAstonParishCouncil.gov.uk			
wheatleyparishcouncil.gov.uk			
westyorksfire.gov.uk			
westwitteringparishcouncil.gov.uk			
westonbywellandparishcouncil.gov.uk			
westmidsfire.gov.uk			
westmidlands-pcc.gov.uk			
westmidlandsca.gov.uk			
westmercia-pcc.gov.uk			
westlondonwaste.gov.uk			
westleigh-devon.gov.uk			
westlancsdc.gov.uk			
westlancashire.gov.uk			
westgrinstead-pc.gov.uk			
westgateonsea.gov.uk			
westerhamtowncouncil.gov.uk			
westend-pc.gov.uk			
westcottparishcouncil.gov.uk			
westbletchleycouncil.gov.uk			
welton-pc.gov.uk			
welshpooltowncouncil.gov.uk			
welshamptonandlyneal-pc.gov.uk			
warminster-tc.gov.uk			
wareham-tc.gov.uk			
wantagetowncouncil.gov.uk			
walton-pc.gov.uk			
waltoncommunitycouncil.gov.uk			
walthamforestclass.gov.uk			
walthamabbey-tc.gov.uk			
wall-pc.gov.uk			
walesfire.gov.uk			
wadebridge-tc.gov.uk			
waddingham.gov.uk			
waddesdonparishcouncil.gov.uk			
volcomgrantsni.gov.uk			
uregni.gov.uk			
upton-pc.gov.uk			
upperwitham-idb.gov.uk			
upperrissington-pc.gov.uk			
uckfieldtc.gov.uk			
tywardreathandparparishcouncil.gov.uk			
tyneandwearpte.gov.uk			
tyneandwearfire.gov.uk			
twyfordparishcouncil.gov.uk			
twineham-pc.gov.uk			
twfire.gov.uk			
tupton-pc.gov.uk			
truro.gov.uk			
truro-city.gov.uk			
treetonparishcouncil.gov.uk			
winslowtowncouncil.gov.uk			
windermere-tc.gov.uk			
traffic-penalty-tribunal.gov.uk			
trafficpenaltychargetribunal.gov.uk			
traffic-penalty-charge-tribunal.gov.uk			
trafficpenaltyadjudicators.gov.uk			
traffic-penalty-adjudicators.gov.uk			
tracc.gov.uk			
towynkinmelbay-tc.gov.uk			
towcester-tc.gov.uk			
wilsdenparishcouncil.gov.uk			
totton-and-eling-tc.gov.uk			
torpointtowncouncil.gov.uk			
whitworth.gov.uk			
tollertonparishcouncil.gov.uk			
tockenhamparishcouncil.gov.uk			
whiston-tc.gov.uk			
tiptreeparishcouncil.gov.uk			
wheldrake-pc.gov.uk			
tintagelparishcouncil.gov.uk			
wheathampstead-pc.gov.uk			
tibshelfparishcouncil.gov.uk			
westyorkshire-pcp.gov.uk			
thurstonparishcouncil.gov.uk			
thursley-pc.gov.uk			
thorpestandrew-tc.gov.uk			
thorne-moorends.gov.uk			
westyorks-ca.gov.uk			
thirsk-tc.gov.uk			
thirdpartyreview.gov.uk			
thetfordtowncouncil.gov.uk			
thestukeleys-pc.gov.uk			
westparley-pc.gov.uk			
westononthegreen-pc.gov.uk			
themcmanus-dundee.gov.uk			
thanington-pc.gov.uk			
tewkesburytowncouncil.gov.uk			
tetbury.gov.uk			
tenterdentowncouncil.gov.uk			
telscombetowncouncil.gov.uk			
tellmescotland.gov.uk			
teignmouth-devon.gov.uk			
west-dunbarton.gov.uk			
tayside-vjb.gov.uk			
taysideprocurement.gov.uk			
taysidefire.gov.uk			
tayplan-sdpa.gov.uk			
tass.gov.uk			
wirral.gov.uk			
tarleton-pc.gov.uk			
tancgc.gov.uk			
tadleytowncouncil.gov.uk			
tactran.gov.uk			
syjs.gov.uk			
thrapstontowncouncil.gov.uk			
syfire.gov.uk			
swmcrematorium.gov.uk			
swinfordparishcouncil.gov.uk			
swcouncils.gov.uk			
swansea.gov.uk			
swansea-edunet.gov.uk			
westernriversiderecyclers.gov.uk			
swanscombeandgreenhithetowncouncil.gov.uk			
swanleytowncouncil.gov.uk			
swanage.gov.uk			
swallowfieldpc.gov.uk			
suttonparishcouncil.gov.uk			
sutton.gov.uk			
warton-pc.gov.uk			
suttoncourtenay-pc.gov.uk			
suttoncoldfieldtowncouncil.gov.uk			
suttonbengerparishcouncil.gov.uk			
visitsaffronwalden.gov.uk			
sunderland.gov.uk			
victimsni.gov.uk			
Sullington-pc.gov.uk			
suffolk-pcc.gov.uk			
suffolk-fire.gov.uk			
sturry-pc.gov.uk			
sturminsternewton-tc.gov.uk			
ststephenparishcouncil.gov.uk			
stroudtown.gov.uk			
stroud-pc.gov.uk			
street-pc.gov.uk			
strattonstmargaret.gov.uk			
stratfield-mortimer.gov.uk			
stowonthewold-tc.gov.uk			
stowmaries-pc.gov.uk			
stourporttowncouncil.gov.uk			
stosyth.gov.uk			
storrington-pc.gov.uk			
stonystratford.gov.uk			
stonetowncouncil.gov.uk			
stondon-pc.gov.uk			
stokepogesparishcouncil.gov.uk			
stokenham-pc.gov.uk			
stokeandhurleston-pc.gov.uk			
stock-pc.gov.uk			
stneots-tc.gov.uk			
stmaryhoo-pc.gov.uk			
stives-tc.gov.uk			
stirlingcastle.gov.uk			
stirchleyandbrooksideparishcouncil.gov.uk			
sthelens.gov.uk			
stharmoncommunitycouncil.gov.uk			
stgeorgesandpriorslee-pc.gov.uk			
sterth-pc.gov.uk			
steeton-with-eastburnparishcouncil.gov.uk			
steep-pc.gov.uk			
steepleclaydonparishcouncil.gov.uk			
steeplebumpstead-pc.gov.uk			
stedhamwithiping-pc.gov.uk			
stdonats-cc.gov.uk			
stdavids.gov.uk			
stcolumbmajor-tc.gov.uk			
stcleerparishcouncil.gov.uk			
staveleytowncouncil.gov.uk			
stateaidscotland.gov.uk			
stasaphcitycouncil.gov.uk			
stapenhillparishcouncil.gov.uk			
stapeleyparishcouncil.gov.uk			
stansted-pc.gov.uk			
stansteadabbottsparishcouncil.gov.uk			
stannesonthesea-tc.gov.uk			
stanley-tc.gov.uk			
stanfordrivers-pc.gov.uk			
stanbridgeparishcouncil.gov.uk			
stamfordtowncouncil.gov.uk			
stamfordbridge-pc.gov.uk			
stallenparishcouncil.gov.uk			
stalbridgetowncouncil.gov.uk			
stainingparishcouncil.gov.uk			
staffordshirefire.gov.uk			
spurstow-pc.gov.uk			
sps.gov.uk			
sprowston-tc.gov.uk			
sppa.gov.uk			
spatialni.gov.uk			
sparse.gov.uk			
spaldingtonparishcouncil.gov.uk			
southyorkshire-pcc.gov.uk			
southyorks.gov.uk			
southwoodhamferrerstc.gov.uk			
southwingfieldparishcouncil.gov.uk			
southwick-widley-pc.gov.uk			
southwell-tc.gov.uk			
southwater-pc.gov.uk			
southwales-tra.gov.uk			
southwales-fire.gov.uk			
southnormantonparishcouncil.gov.uk			
south-norfolk.gov.uk			
south-hill-pc.gov.uk			
southferribyparishcouncil.gov.uk			
southern-ifca.gov.uk			
southeastiep.gov.uk			
southcavepc.gov.uk			
southbrent.gov.uk			
wlga.gov.uk			
south-ayrshire.gov.uk			
southamcouncil-warks.gov.uk			
sonning-pc.gov.uk			
somertontowncouncil.gov.uk			
somersham-pc.gov.uk			
somersetwaste.gov.uk			
somersetdrainageboards.gov.uk			
soils-scotland.gov.uk			
soham-tc.gov.uk			
sodburytowncouncil.gov.uk			
sns.gov.uk			
snowdonia-npa.gov.uk			
s-norfolk.gov.uk			
slinfold-pc.gov.uk			
slimbridge-pc.gov.uk			
sleaford.gov.uk			
skiptontowncouncil.gov.uk			
skelton-york.gov.uk			
sitlingtonparishcouncil.gov.uk			
siryfflint.gov.uk			
sirgar.gov.uk			
sirgaerfyrddin.gov.uk			
sirfynwy.gov.uk			
sirddinbych.gov.uk			
silverendparishcouncil.gov.uk			
silverdale-pc-lancs.gov.uk			
silloth-on-solway-tc.gov.uk			
silkstoneparishcouncil.gov.uk			
silchester-pc.gov.uk			
sidmouth.gov.uk			
shropshirefire.gov.uk			
shrewsburytowncouncil.gov.uk			
shottonparishcouncil.gov.uk			
shorehamparishcouncil.gov.uk			
valeofglamorgan.gov.uk			
shiregroup-idbs.gov.uk			
shirebrooktowncouncil.gov.uk			
shinfieldparish.gov.uk			
shildon.gov.uk			
shevingtonpc.gov.uk			
sherfieldparkparishcouncil.gov.uk			
sherfieldonloddon-pc.gov.uk			
shereparishcouncil.gov.uk			
sherburninelmet-pc.gov.uk			
sherborne-tc.gov.uk			
sherbornestjohn-pc.gov.uk			
sheptonmallettowncouncil.gov.uk			
shenleybrookend-pc.gov.uk			
sheetparishcouncil.gov.uk			
shearsbyparishcouncil.gov.uk			
shawbury-pc.gov.uk			
shaughpriorparish.gov.uk			
sharedresourceservicewales.gov.uk			
shaftesbury-tc.gov.uk			
sflg.gov.uk			
sewta.gov.uk			
sevenoakstown.gov.uk			
sestran.gov.uk			
service.gov.uk			
sepa.gov.uk			
selseytowncouncil.gov.uk			
sellindge-pc.gov.uk			
selborneparishcouncil.gov.uk			
seergreenparishcouncil.gov.uk			
sedsh.gov.uk			
stivestowncouncil-cornwall.gov.uk			
sedgefieldtowncouncil.gov.uk			
seatonvalleycommunitycouncil.gov.uk			
westlancs.gov.uk			
seaton.gov.uk			
seaham.gov.uk			
seagryparishcouncil.gov.uk			
seafordtowncouncil.gov.uk			
scrol.gov.uk			
scra.gov.uk			
scottishschoolsonline.gov.uk			
scottishrateablevalues.gov.uk			
scottishparoleboard.gov.uk			
scottishhousingregulator.gov.uk			
scottishflooddefences.gov.uk			
scottishfamilies.gov.uk			
scottishelectoralregister.gov.uk			
scottishciviljusticecouncil.gov.uk			
scottishchildcare.gov.uk			
scottishboundaries.gov.uk			
scottishassessorsportal.gov.uk			
scottishassessors.gov.uk			
scotlandsprotectedplaces.gov.uk			
scotlandsproperty.gov.uk			
scotlandsplaces.gov.uk			
scotlandshouseprices.gov.uk			
scotlandsfinancialhealthservice.gov.uk			
stantononthewoldsparishcouncil.gov.uk			
scotlandontap.gov.uk			
scotland.gov.uk			
scot.gov.uk			
scotcourtstribunals.gov.uk			
scotcourt.gov.uk			
scotborders.gov.uk			
scords.gov.uk			
scillyifca.gov.uk			
westyorkshire-pcc.gov.uk			
scap.gov.uk			
sawtry-pc.gov.uk			
sawbridgeworth-tc.gov.uk			
saughall.gov.uk			
satleyparishcouncil.gov.uk			
sasa.gov.uk			
sandytowncouncil.gov.uk			
sandymoorparishcouncil.gov.uk			
sandwichtowncouncil.gov.uk			
sandridge-pc.gov.uk			
sandowntowncouncil.gov.uk			
sandhurst-kent-pc.gov.uk			
sandhurst.gov.uk			
sandbach.gov.uk			
sampfordcourtenay-pc.gov.uk			
saltneytowncouncil.gov.uk			
saltash.gov.uk			
salcombetowncouncil.gov.uk			
sais.gov.uk			
saffronwalden.gov.uk			
saas.gov.uk			
worlestondistrict-pc.gov.uk			
saa.gov.uk			
ryetowncouncil.gov.uk			
shenstone-staffs.gov.uk			
rydetowncouncil.gov.uk			
ruthintowncouncil.gov.uk			
rushdentowncouncil.gov.uk			
ruralni.gov.uk			
rugeleytowncouncil.gov.uk			
rufforthwithknapton-pc.gov.uk			
ruddingtonparishcouncil.gov.uk			
ruckinge-pc.gov.uk			
rsh.gov.uk			
stratford-tc.gov.uk			
rpani.gov.uk			
royalwoottonbassett.gov.uk			
royal.gov.uk			
royalberkshirefire.gov.uk			
rottingdean-pc.gov.uk			
rosstc-herefordshire.gov.uk			
ros.gov.uk			
romanby-pc.gov.uk			
rogateparishcouncil.gov.uk			
rochfordparishcouncil.gov.uk			
rocheparishcouncil.gov.uk			
rmascotland.gov.uk			
riversagencyni.gov.uk			
rippondenparishcouncil.gov.uk			
riponcity.gov.uk			
ripleytowncouncil.gov.uk			
ripleyparishcouncil.gov.uk			
ringwood.gov.uk			
ringmerparishcouncil.gov.uk			
rhondda-cynon-taff.gov.uk			
repton-pc.gov.uk			
renfrewshire-vjb.gov.uk			
renewnorthstaffs.gov.uk			
bingham-tc.gov.uk			
redundancyni.gov.uk			
billingsley-pc.gov.uk			
billericaytowncouncil.gov.uk			
redbourneparishcouncil.gov.uk			
rcahmw.gov.uk			
randwickandwestrip-pc.gov.uk			
ramseyparkeston-pc.gov.uk			
quarndon-pc.gov.uk			
almondsburyparishcouncil.gov.uk			
qltr.gov.uk			
eshparishcouncil.gov.uk			
pwlb.gov.uk			
puttenham-pc.gov.uk			
purtonparishcouncil.gov.uk			
puritonparishcouncil.gov.uk			
broughtonwrexhamcommunitycouncil.gov.uk			
procuratorfiscal.gov.uk			
probusparishcouncil.gov.uk			
privatewatersupplies.gov.uk			
prisonsinspectoratescotland.gov.uk			
biltoninainstywithbickerton-pc.gov.uk			
prhpscotland.gov.uk			
prestonpatrick-pc.gov.uk			
frs-scotland.gov.uk			
poringlandparishcouncil.gov.uk			
flitwick.gov.uk			
PontarddulaisTownCouncil.gov.uk			
polperrocommunitycouncil.gov.uk			
policyprofession.gov.uk			
policeconduct.gov.uk			
polegatetowncouncil.gov.uk			
pointer-ni.gov.uk			
fleet-tc.gov.uk			
bedale-tc.gov.uk			
planforbritain.gov.uk			
pickering.gov.uk			
pevenseyparishcouncil.gov.uk			
pershore-tc.gov.uk			
wokinghamwithoutparishcouncil.gov.uk			
queensferrycommunitycouncil.gov.uk			
penworthamtowncouncil.gov.uk			
fepd.gov.uk			
prestonbrookparishcouncil.gov.uk			
pencoedtowncouncil.gov.uk			
archifaugwent.gov.uk			
PenarthTownCouncil.gov.uk			
rhuddlantowncouncil.gov.uk			
peltonparishcouncil.gov.uk			
rhosdducommunitycouncil.gov.uk			
pegswood-pc.gov.uk			
nidirect.gov.uk			
peasedownstjohnparishcouncil.gov.uk			
patent.gov.uk			
anstystaplefield-pc.gov.uk			
haltwhistle-tc.gov.uk			
parciaucenedlaetholcymru.gov.uk			
pannalandburnbridge-pc.gov.uk			
pancrasweekparishcouncil.gov.uk			
pamber-pc.gov.uk			
padihamtowncouncil.gov.uk			
falkirk.gov.uk			
rayne-essex.gov.uk			
devonsomersettradingstandards.gov.uk			
oultonbroadparishcouncil.gov.uk			
otterystmary-tc.gov.uk			
otleytowncouncil.gov.uk			
Radstock-tc.gov.uk			
oswestryrural-pc.gov.uk			
exmouth.gov.uk			
orcl.gov.uk			
educationscotland.gov.uk			
oqps.gov.uk			
opsi.gov.uk			
quedgeley-pc.gov.uk			
opendatani.gov.uk			
onlineni.gov.uk			
AlbrightonParishCouncil.gov.uk			
littlesomerfordparishcouncil.gov.uk			
ongartowncouncil.gov.uk			
omagh.gov.uk			
purleyonthames-pc.gov.uk			
olvestonparishcouncil.gov.uk			
ashwell.gov.uk			
oldbasing.gov.uk			
okehamptonhamlets-pc.gov.uk			
okehampton.gov.uk			
okefordfitzpaine-pc.gov.uk			
rayleightowncouncil.gov.uk			
wroughton.gov.uk			
ukexportfinance.gov.uk			
chichestercity.gov.uk			
ofwat.gov.uk			
odandd.gov.uk			
oclepychardgroup-pc.gov.uk			
oakleydeane-pc.gov.uk			
muchwenlock-tc.gov.uk			
burlescombe-pc.gov.uk			
nw-ifca.gov.uk			
stmartinsparishcouncil.gov.uk			
n-somerset.gov.uk			
stjamesisleofgrain-pc.gov.uk			
npt.gov.uk			
northwales-pcc.gov.uk			
steyningpc.gov.uk			
northwalesfostering.gov.uk			
northwalesadoption.gov.uk			
sandudb.gov.uk			
pesticides.gov.uk			
stbriavels-pc.gov.uk			
northingtonparishcouncil.gov.uk			
northhykehamtowncouncil.gov.uk			
northhorsham-pc.gov.uk			
local.gov.uk			
helionsbumpsteadparishcouncil.gov.uk			
northcrawley-pc.gov.uk			
northamtowncouncil.gov.uk			
normandyparishcouncil.gov.uk			
norfolk-pcc.gov.uk			
ctt.gov.uk			
norfolkalc.gov.uk			
no10.gov.uk			
nlwa.gov.uk			
IlloganParishCouncil.gov.uk			
amesburytowncouncil.gov.uk			
nigov.gov.uk			
IlchesterParishCouncil.gov.uk			
nifca.gov.uk			
nicsrecruitment.gov.uk			
nicsohs.gov.uk			
nicscommissioners.gov.uk			
nical.gov.uk			
niassembly.gov.uk			
featherstone-tc.gov.uk			
newtownabbey.gov.uk			
newton-cambridge-pc.gov.uk			
newtonandnoss-pc.gov.uk			
newtonabbot-tc.gov.uk			
newportshropshire-tc.gov.uk			
newlandparishcouncil.gov.uk			
newhollandparishcouncil.gov.uk			
newfrankleyinbirminghamparishcouncil.gov.uk			
newdigateparishcouncil.gov.uk			
liskeard.gov.uk			
newark.gov.uk			
nettleham-pc.gov.uk			
securityservice.gov.uk			
netregs.gov.uk			
ponteland-tc.gov.uk			
netherstowey-pc.gov.uk			
northeastcouncils.gov.uk			
nelsontowncouncil.gov.uk			
nelson-mid-glam.gov.uk			
lg-em.gov.uk			
caernarfontowncouncil.gov.uk			
nationalparkswales.gov.uk			
nationalfraudinitiative.gov.uk			
nationalemploymentpanel.gov.uk			
nationalcrimeagency.gov.uk			
cctmark.gov.uk			
NashMillsParishCouncil.gov.uk			
nas.gov.uk			
northumbria-pcc.gov.uk			
narboroughparishcouncil.gov.uk			
lewes-tc.gov.uk			
nao.gov.uk			
nantwichtowncouncil.gov.uk			
leslp.gov.uk			
nalc.gov.uk			
nailseatowncouncil.gov.uk			
legsb.gov.uk			
myjobscotland.gov.uk			
myddleandbroughton-pc.gov.uk			
eckington-pc.gov.uk			
mudfordparishcouncil.gov.uk			
mountedgcumbe.gov.uk			
ecclesfield-pc.gov.uk			
moultonnorthants-pc.gov.uk			
mostyncommunitycouncil.gov.uk			
morville-pc.gov.uk			
morley.gov.uk			
moretonvalence-pc.gov.uk			
morecambe.gov.uk			
broads-authority.gov.uk			
eastgarston-pc.gov.uk			
lbwf.gov.uk			
moray.gov.uk			
moray-edunet.gov.uk			
monksherborne-pc.gov.uk			
monkhesledenparishcouncil.gov.uk			
berkhamstedtowncouncil.gov.uk			
mollingtonoxon-pc.gov.uk			
staffordshire-pcc.gov.uk			
molescroft-pc.gov.uk			
nilawcommission.gov.uk			
eastilsley-pc.gov.uk			
horwich.gov.uk			
mitfordparishcouncil.gov.uk			
misterton-notts-pc.gov.uk			
miserden-pc.gov.uk			
hmie.gov.uk			
mirfieldtowncouncil.gov.uk			
minternemagnaparishcouncil.gov.uk			
minsterlovell-pc.gov.uk			
minchinhampton-pc.gov.uk			
holmeschapelparishcouncil.gov.uk			
miltonunderwychwood-pc.gov.uk			
millbrook-pc.gov.uk			
middleton-northants-pc.gov.uk			
middletonbywirksworth-pc.gov.uk			
wiltshire-pcc.gov.uk			
middlelevel.gov.uk			
pembridgeparishcouncil.gov.uk			
midandeastantrim.gov.uk			
towerhamlets.gov.uk			
audit-scotland.gov.uk			
micklefield-pc.gov.uk			
newbury.gov.uk			
merseytunnels.gov.uk			
gla.gov.uk			
merseysidewda.gov.uk			
melthamtowncouncil.gov.uk			
roystontowncouncil.gov.uk			
mawwfire.gov.uk			
oxenhopeparishcouncil.gov.uk			
ashingtontowncouncil.gov.uk			
maryporttowncouncil.gov.uk			
skegness.gov.uk			
raunds-tc.gov.uk			
thornburytowncouncil.gov.uk			
marlow-tc.gov.uk			
marlboroughtowncouncil.gov.uk			
peterlee.gov.uk			
thornabytowncouncil.gov.uk			
arundeltowncouncil.gov.uk			
marlborough-tc.gov.uk			
marchamparishcouncil.gov.uk			
ramseytowncouncil.gov.uk			
westmoors-pc.gov.uk			
thealeparishcouncil.gov.uk			
oswestry-tc.gov.uk			
westminster.gov.uk			
thatchamtowncouncil.gov.uk			
southernuplandway.gov.uk			
manea-pc.gov.uk			
manchesterfire.gov.uk			
malton-tc.gov.uk			
malmesbury.gov.uk			
scpha.gov.uk			
maidennewton-pc.gov.uk			
tpt.gov.uk			
tpct.gov.uk			
macscotland.gov.uk			
newmarket.gov.uk			
westburytowncouncil.gov.uk			
tavistock.gov.uk			
lymmparishcouncil.gov.uk			
princeofwales.gov.uk			
westburysubmendip-pc.gov.uk			
lymeregistowncouncil.gov.uk			
lydiateparishcouncil.gov.uk			
parbold-pc.gov.uk			
finchampstead-pc.gov.uk			
lowestofttowncouncil.gov.uk			
louthtowncouncil.gov.uk			
loughton-tc.gov.uk			
wellington-shropshire.gov.uk			
loughtonandgreatholm-pc.gov.uk			
lostwithieltowncouncil.gov.uk			
lordsappointments.gov.uk			
loppingtonparishcouncil.gov.uk			
looetowncouncil.gov.uk			
longridge-tc.gov.uk			
northyorkshire-pcc.gov.uk			
longdonworcs-pc.gov.uk			
swaffhamtowncouncil.gov.uk			
northyorksfire.gov.uk			
CamParishCouncil.gov.uk			
longborough-pc.gov.uk			
fscc.gov.uk			
great-torringtontowncouncil.gov.uk			
psecni.gov.uk			
londonworks.gov.uk			
londontribunals.gov.uk			
surrey-pcc.gov.uk			
londonlibraries.gov.uk			
bedsfire.gov.uk			
PershoreTownCouncil.gov.uk			
london-fire.gov.uk			
northleach.gov.uk			
gse.gov.uk			
localgovernmentjobsni.gov.uk			
LlwchwrTownCouncil.gov.uk			
llantwitmajortowncouncil.gov.uk			
llangollentowncouncil.gov.uk			
llangennechcommunitycouncil.gov.uk			
llanfaircommunitycouncil.gov.uk			
llandeilo.gov.uk			
littlestanney-pc.gov.uk			
avonfrs.gov.uk			
littleportparishcouncil.gov.uk			
yeoviltonparishcouncil.gov.uk			
cabinetoffice.gov.uk			
littlemoreparishcouncil.gov.uk			
wallingfordtowncouncil.gov.uk			
LittleHarrowdenParishCouncil.gov.uk			
businesslink.gov.uk			
littlehampton-tc.gov.uk			
yealmpton-pc.gov.uk			
littlehadham-pc.gov.uk			
littlealtcar-pc.gov.uk			
burringhamparishcouncil.gov.uk			
lintoncambridgeshire-pc.gov.uk			
chetnoleandstockwood-pc.gov.uk			
lincoln.gov.uk			
ncsc.gov.uk			
lge.gov.uk			
lga.gov.uk			
NewcastleEmlynTownCouncil.gov.uk			
chelveston-pc.gov.uk			
leominstertowncouncil.gov.uk			
bude-stratton.gov.uk			
leistontowncouncil.gov.uk			
leighonseatowncouncil.gov.uk			
buckingham-tc.gov.uk			
godstone-pc.gov.uk			
mumbles.gov.uk			
leek-tc.gov.uk			
leedscityregion.gov.uk			
ledshamparishcouncil.gov.uk			
ledburytowncouncil.gov.uk			
leacottam-pc.gov.uk			
niprisonerombudsman.gov.uk			
lbhf.gov.uk			
monmouth.gov.uk			
lbbd.gov.uk			
historicwales.gov.uk			
launceston-tc.gov.uk			
lanivetparishcouncil.gov.uk			
bringtons-pc.gov.uk			
wisbechtowncouncil.gov.uk			
lancashire-pcc.gov.uk			
bridgwatertowncouncil.gov.uk			
lanarkshire-vjb.gov.uk			
bridgnorthtowncouncil.gov.uk			
ealc.gov.uk			
lampeter-tc.gov.uk			
transportscotland.gov.uk			
lalestoncommunitycouncil.gov.uk			
transportforlondon.gov.uk			
lacockparishcouncil.gov.uk			
trafficpenaltytribunal.gov.uk			
axbridge-tc.gov.uk			
earley-tc.gov.uk			
knowsleytowncouncil.gov.uk			
knetni.gov.uk			
knebworthparishcouncil.gov.uk			
KnaresboroughTownCouncil.gov.uk			
kltr.gov.uk			
kirtoninlindseytowncouncil.gov.uk			
ofmdfmni.gov.uk			
kippaxparishcouncil.gov.uk			
kingtontowncouncil.gov.uk			
buckinghampark-pc.gov.uk			
kingsteignton.gov.uk			
whitwell-pc.gov.uk			
kingshillparish.gov.uk			
pas.gov.uk			
whithornpriorymuseum.gov.uk			
kimboltonandstonely-pc.gov.uk			
whitehilltowncouncil.gov.uk			
titleygroup-pc.gov.uk			
stalbans.gov.uk			
killamarsh-pc.gov.uk			
tisbury-wiltshire-pc.gov.uk			
dronfield.gov.uk			
kilkhampton-pc.gov.uk			
kidsgrovetowncouncil.gov.uk			
kettlewell-starbotton-pc.gov.uk			
thurmastonpc.gov.uk			
keswicktowncouncil.gov.uk			
ashford-in-the-water-pc.gov.uk			
kerrycommunitycouncil.gov.uk			
keresley-pc.gov.uk			
kenwynparishcouncil.gov.uk			
lgyh.gov.uk			
kentandessex-ifca.gov.uk			
tivertontowncouncil.gov.uk			
kimberley-tc.gov.uk			
kentalc.gov.uk			
kendaltowncouncil.gov.uk			
kelvedonhatch-pc.gov.uk			
keighley.gov.uk			
longstratton-pc.gov.uk			
justice-ni.gov.uk			
marketbosworth-pc.gov.uk			
judiciaryni.gov.uk			
judiciary-ni.gov.uk			
agma.gov.uk			
centralscotlandfire.gov.uk			
dormingtonmordifordgroup-pc.gov.uk			
lothian-vjb.gov.uk			
judicialappointmentsscotland.gov.uk			
jpscotland.gov.uk			
jobsandgrowthni.gov.uk			
thametowncouncil.gov.uk			
ivybridge.gov.uk			
iverparishcouncil.gov.uk			
itt.gov.uk			
roadworksscotland.gov.uk			
isni.gov.uk			
irthlingborough-tc.gov.uk			
independent.gov.uk			
immingham-tc.gov.uk			
ilfracombetowncouncil.gov.uk			
hydro.gov.uk			
greenham.gov.uk			
hunstantontowncouncil.gov.uk			
hunningtonparishcouncil.gov.uk			
lymingtonandpennington-tc.gov.uk			
ceop.gov.uk			
hullandgoolepha.gov.uk			
sussex-pcc.gov.uk			
churchstretton-tc.gov.uk			
hucclecotepc.gov.uk			
queensparkcommunitycouncil.gov.uk			
hsl.gov.uk			
stmellion-pc.gov.uk			
clevedon.gov.uk			
lindfieldparishcouncil.gov.uk			
horrabridge-pc.gov.uk			
alcester-tc.gov.uk			
horleysurrey-tc.gov.uk			
walescoastpath.gov.uk			
hordleparishcouncil.gov.uk			
wadhurst-pc.gov.uk			
hopecommunitycouncil.gov.uk			
hoosaintwerburgh-pc.gov.uk			
tyneandwearltp.gov.uk			
hook.gov.uk			
chiltonpolden-pc.gov.uk			
holmwoodparishcouncil.gov.uk			
urchfont-pc.gov.uk			
holme-westmorland-pc.gov.uk			
rctcbc.gov.uk			
hockley-essex.gov.uk			
uphollandpc.gov.uk			
chiddingly.gov.uk			
llwybrarfordircymru.gov.uk			
twyford-bucks-pc.gov.uk			
hmcg.gov.uk			
aberporthcommunitycouncil.gov.uk			
hinstock-pc.gov.uk			
trowbridge.gov.uk			
highworthtowncouncil.gov.uk			
trimdonparishcouncil.gov.uk			
highleghparishcouncil.gov.uk			
hie.gov.uk			
heybridgeparishcouncil.gov.uk			
Hertspartnership-ala.gov.uk			
littlehoughtonparishcouncilnorthants.gov.uk			
knutsfordtowncouncil.gov.uk			
hertfordheath.gov.uk			
hertford.gov.uk			
herriard-pc.gov.uk			
herefordcitycouncil.gov.uk			
henlow-pc.gov.uk			
henleytowncouncil.gov.uk			
helston-tc.gov.uk			
hellesdon-pc.gov.uk			
hedon.gov.uk			
hedgeend-tc.gov.uk			
heathandholmewood-pc.gov.uk			
haxbytowncouncil.gov.uk			
haworthparishcouncil.gov.uk			
hawkinge-tc.gov.uk			
rawdonparishcouncil.gov.uk			
ofsted.gov.uk			
hawkesbury-pc.gov.uk			
hawardencommunitycouncil.gov.uk			
wattontowncouncil.gov.uk			
proni.gov.uk			
hathersageparishcouncil.gov.uk			
SlindonParishCouncil.gov.uk			
hassocks-pc.gov.uk			
hartwellparishcouncil.gov.uk			
rodborough.gov.uk			
kent-pcc.gov.uk			
harpenden.gov.uk			
harlington-pc.gov.uk			
haringey.gov.uk			
hardwickepc.gov.uk			
hardingstoneparishcouncil.gov.uk			
hardenparishcouncil.gov.uk			
harbury-pc.gov.uk			
carltoncolvilletowncouncil.gov.uk			
ipplepenparishcouncil.gov.uk			
wemrural-pc.gov.uk			
intellectual-property.gov.uk			
hambledon-pc.gov.uk			
ingatestone-fryerningpc.gov.uk			
halewoodtowncouncil.gov.uk			
angmeringparishcouncil.gov.uk			
halesandheckingham-pc.gov.uk			
halchereford.gov.uk			
gwynedd.gov.uk			
londonprepared.gov.uk			
buyni.gov.uk			
gwineargwithian-pc.gov.uk			
guildenmorden.gov.uk			
paghamparishcouncil.gov.uk			
swillingtonparishcouncil.gov.uk			
gsx.gov.uk			
gsi.gov.uk			
padstow-tc.gov.uk			
neathtowncouncil.gov.uk			
greatwakering-pc.gov.uk			
great-linford.gov.uk			
hucklow-pc.gov.uk			
greatglen-pc.gov.uk			
greatermanchester-ca.gov.uk			
greatbursteadsouthgreenparishcouncil.gov.uk			
greatamwellparishcouncil.gov.uk			
grangeoversandstowncouncil.gov.uk			
grampian-vjb.gov.uk			
grampian-ero.gov.uk			
grampiancaredata.gov.uk			
eoni.gov.uk			
tring.gov.uk			
falstoneparishcouncil.gov.uk			
newhaventowncouncil.gov.uk			
willinghamparishcouncil.gov.uk			
totnestowncouncil.gov.uk			
goytre.gov.uk			
govcertuk.gov.uk			
woughtoncommunitycouncil.gov.uk			
GorseinonTownCouncil.gov.uk			
goole-tc.gov.uk			
bearstedparishcouncil.gov.uk			
gmwda.gov.uk			
eelga.gov.uk			
lancaster.gov.uk			
glsni.gov.uk			
chscotland.gov.uk			
hortonparishcouncil.gov.uk			
gillinghamdorset-tc.gov.uk			
gerrardscross.gov.uk			
brockworth-pc.gov.uk			
georgehamparishcouncil.gov.uk			
mersey-pha.gov.uk			
cowbridge-tc.gov.uk			
womersleyparishcouncil.gov.uk			
broadstairs.gov.uk			
gcvgreennetwork.gov.uk			
ackworthparishcouncil.gov.uk			
boundarycommissionengland.gov.uk			
northwichtowncouncil.gov.uk			
frometowncouncil.gov.uk			
frodsham.gov.uk			
pmo.gov.uk			
alderleyedge-pc.gov.uk			
cumbria-pcc.gov.uk			
frensham-pc.gov.uk			
llanellitowncouncil.gov.uk			
bridgendtowncouncil.gov.uk			
llandudno.gov.uk			
northernireland.gov.uk			
bransgore-parish.gov.uk			
FireScotland.gov.uk			
northeastca.gov.uk			
nereo.gov.uk			
limavady.gov.uk			
finchingfield-pc.gov.uk			
finance-ni.gov.uk			
pkc.gov.uk			
fife.gov.uk			
tobaccoregisterni.gov.uk			
kingsbridge.gov.uk			
marketdrayton.gov.uk			
cert.gov.uk			
tfl.gov.uk			
loose-pc.gov.uk			
glamro.gov.uk			
dundeecity.gov.uk			
aston-cum-aughton-pc.gov.uk			
faststream.gov.uk			
aldercarandlangleymillparishcouncil.gov.uk			
lgdu-wales.gov.uk			
farrier-reg.gov.uk			
merthyr.gov.uk			
chiltondurham-tc.gov.uk			
farnhamroyal-pc.gov.uk			
pacni.gov.uk			
farnham.gov.uk			
uppinghamtowncouncil.gov.uk			
faringdontowncouncil.gov.uk			
cossingtonparishcouncil.gov.uk			
fairoak-pc.gov.uk			
ashurstwood-vc.gov.uk			
fairfordtowncouncil.gov.uk			
holtparishcouncil.gov.uk			
cheswickgreen-pc.gov.uk			
cookstown.gov.uk			
exminsterparishcouncil.gov.uk			
eveshamtowncouncil.gov.uk			
newbiggintowncouncil.gov.uk			
candm-pc.gov.uk			
etendersni.gov.uk			
chelshamandfarleigh-pc.gov.uk			
bucksfire.gov.uk			
essex-fire.gov.uk			
sampfordarundel-pc.gov.uk			
college-of-arms.gov.uk			
zennorparishcouncil.gov.uk			
eryri-npa.gov.uk			
courtsni.gov.uk			
matlock.gov.uk			
aspatria-tc.gov.uk			
martham.gov.uk			
angmering-pc.gov.uk			
parentzonescotland.gov.uk			
merseytravel.gov.uk			
bcomm-scotland.gov.uk			
parking-appeals.gov.uk			
tpa.gov.uk			
gmtu.gov.uk			
emani.gov.uk			
elstreeborehamwood-tc.gov.uk			
godalming-jbc.gov.uk			
northclainesparishcouncil.gov.uk			
ellesmere-tc.gov.uk			
bursledon-pc.gov.uk			
lintonpc-herefordshire.gov.uk			
coxhoeparishcouncil.gov.uk			
ecgd.gov.uk			
glow.gov.uk			
burtondassett-pc.gov.uk			
lisburncastlereagh.gov.uk			
beacons-npa.gov.uk			
ehsni.gov.uk			
hmso.gov.uk			
gloucestershire-pcc.gov.uk			
education-ni.gov.uk			
hungerford-tc.gov.uk			
aylsham-tc.gov.uk			
data.gov.uk			
edingtonsomersetparishcouncil.gov.uk			
homereportscotland.gov.uk			
edinburghcastle.gov.uk			
kingswoodparishcouncil.gov.uk			
edenbridgetowncouncil.gov.uk			
ecchinswell-pc.gov.uk			
glosfire.gov.uk			
beltonparishcouncil.gov.uk			
pontypriddtowncouncil.gov.uk			
northandmiddlelittleton-pc.gov.uk			
alconburyparishcouncil.gov.uk			
horndeanpc-hants.gov.uk			
felphampc.gov.uk			
woodvilleparishcouncil.gov.uk			
ngflscotland.gov.uk			
felixstowe.gov.uk			
bleadonparishcouncil.gov.uk			
glamarchives.gov.uk			
broughton-astley.gov.uk			
haverhill-tc.gov.uk			
bromyardandwinslow-tc.gov.uk			
eastrenfrewshire.gov.uk			
childrenshearingsscotland.gov.uk			
daventrytowncouncil.gov.uk			
eastlondonwaste.gov.uk			
hullcc.gov.uk			
east-leake.gov.uk			
wokingham-tc.gov.uk			
eastbudleigh-pc.gov.uk			
gcvcore.gov.uk			
ealing.gov.uk			
gct.gov.uk			
hixon.gov.uk			
colnbrookwithpoyle-pc.gov.uk			
gcsx.gov.uk			
merseyfire.gov.uk			
clayton-pc.gov.uk			
durringtontowncouncil.gov.uk			
aberford-pc.gov.uk			
durham-pcc.gov.uk			
dungannon.gov.uk			
hackletonparishcouncil.gov.uk			
binfieldparishcouncil.gov.uk			
redruth-tc.gov.uk			
camelford-tc.gov.uk			
haywardsheath.gov.uk			
dsfire.gov.uk			
cambridgeshire-pcc.gov.uk			
chiddingfold-pc.gov.uk			
opg.gov.uk			
doxeyparishcouncil.gov.uk			
ashpcsurrey.gov.uk			
DowntonParishCouncil.gov.uk			
downdc.gov.uk			
DoverTownCouncil.gov.uk			
chippenhamwithoutparishcouncil.gov.uk			
peatlandsni.gov.uk			
castlebromwichpc.gov.uk			
doddinghurst-pc.gov.uk			
parking-adjudication.gov.uk			
dmo.gov.uk			
carnbreaparishcouncil.gov.uk			
dittonparishcouncil.gov.uk			
rentofficer-ni.gov.uk			
dittishamparishcouncil.gov.uk			
ditchling-pc.gov.uk			
diss.gov.uk			
linets.gov.uk			
dsdni.gov.uk			
carlyon-pc.gov.uk			
spennymoor-tc.gov.uk			
directgov.gov.uk			
southbucks.gov.uk			
royalgreenwich.gov.uk			
didcot.gov.uk			
roadeparishcouncil.gov.uk			
iscjis.gov.uk			
newport.gov.uk			
devonandsevernifca.gov.uk			
thegorgeparishcouncil.gov.uk			
banbury.gov.uk			
devizes-tc.gov.uk			
ipo.gov.uk			
twita.gov.uk			
detini.gov.uk			
desboroughtowncouncil.gov.uk			
orchardpark.gov.uk			
cambridgeshirepeterborough-ca.gov.uk			
bradfordonavontowncouncil.gov.uk			
derbyshire-pcc.gov.uk			
frindsburyextra-pc.gov.uk			
maldontowncouncil.gov.uk			
kingswearparishcouncil.gov.uk			
derbyshirealc.gov.uk			
caerphilly.gov.uk			
derbys-fire.gov.uk			
antrim.gov.uk			
greatdunmow-tc.gov.uk			
causewaycoastandglens.gov.uk			
kingslangley-pc.gov.uk			
dennylodgeparishcouncil.gov.uk			
denham-bucks-pc.gov.uk			
petworth-tc.gov.uk			
deal.gov.uk			
idea.gov.uk			
uleyparishcouncil.gov.uk			
chigwellparishcouncil.gov.uk			
dcal-fishingni.gov.uk			
dawlish.gov.uk			
duffieldparishcouncil.gov.uk			
assembly-ni.gov.uk			
wells.gov.uk			
offords-pc.gov.uk			
burghfieldparishcouncil.gov.uk			
prestatyntowncouncil.gov.uk			
offacommunitycouncil.gov.uk			
buntingford-tc.gov.uk			
gilmortonparishcouncil.gov.uk			
easthuntspillparishcouncil.gov.uk			
datchetparishcouncil.gov.uk			
huncote-pc.gov.uk			
chorleywood-pc.gov.uk			
FiltonTownCouncil.gov.uk			
kirdford-pc.gov.uk			
daera-ni.gov.uk			
edlesborough-pc.gov.uk			
PoyntonTownCouncil.gov.uk			
ashmansworth-pc.gov.uk			
matlockbathparishcouncil.gov.uk			
stotfoldtowncouncil.gov.uk			
darleydale.gov.uk			
kensworthparishcouncil.gov.uk			
woodstock-tc.gov.uk			
sir-benfro.gov.uk			
danbury-essex.gov.uk			
gamlingay-pc.gov.uk			
dorsetfire.gov.uk			
dalburyleesparishcouncil.gov.uk			
cyngortrefybarri.gov.uk			
planningni.gov.uk			
cyngortrefrhuthun.gov.uk			
hampshire-pcc.gov.uk			
shifnaltowncouncil.gov.uk			
aldwickparishcouncil.gov.uk			
broadwindsorgroup.gov.uk			
claycross.gov.uk			
currie-scc.gov.uk			
cogenhoeandwhiston-pc.gov.uk			
watlington-oxon-pc.gov.uk			
cjsrascotland.gov.uk			
bersted-pc.gov.uk			
cullingworthparishcouncil.gov.uk			
londoncolney-pc.gov.uk			
cuckfield.gov.uk			
eastboldre-pc.gov.uk			
sendparishcouncil.gov.uk			
cslearning.gov.uk			
Morpeth-tc.gov.uk			
beckley-and-stowood-pc.gov.uk			
csep.gov.uk			
croxleygreen-pc.gov.uk			
cilcaincommunitycouncil.gov.uk			
berinsfield-pc.gov.uk			
crowboroughtowncouncil.gov.uk			
rotherham.gov.uk			
northlan.gov.uk			
bostockparishcouncil.gov.uk			
astonlewallsparishcouncil.gov.uk			
brickhillparishcouncil.gov.uk			
crowan-pc.gov.uk			
bonbyparishcouncil.gov.uk			
burgesshill.gov.uk			
elstead-pc.gov.uk			
winkfieldparishcouncil.gov.uk			
transport-for-london.gov.uk			
cropwellbishop-pc.gov.uk			
hythetowncouncil.gov.uk			
flintshire.gov.uk			
CRONDALL-PC.gov.uk			
ellesmererural-pc.gov.uk			
churchdown-pc.gov.uk			
fishregister.gov.uk			
cricklade-tc.gov.uk			
crewkerne-tc.gov.uk			
crewetowncouncil.gov.uk			
crediton.gov.uk			
wiltsfire.gov.uk			
hayfield-pc.gov.uk			
EUCompNI.gov.uk			
ukho.gov.uk			
cramlingtontowncouncil.gov.uk			
corsham.gov.uk			
portishead.gov.uk			
cpdni.gov.uk			
lincolnshire-pcc.gov.uk			
felsted-pc.gov.uk			
cowfold-pc.gov.uk			
eastwoodhay-pc.gov.uk			
greatshelfordparishcouncil.gov.uk			
coi.gov.uk			
brampton-cambs-pc.gov.uk			
antrimandnewtownabbey.gov.uk			
patchwaytowncouncil.gov.uk			
woodsettsparishcouncil.gov.uk			
lissparishcouncil.gov.uk			
woodgreen-pc.gov.uk			
eastpeckham-pc.gov.uk			
wakefield.gov.uk			
hordenparishcouncil.gov.uk			
cotgrave-tc.gov.uk			
tidworthtowncouncil.gov.uk			
ashurstandcolbury-pc.gov.uk			
fairfieldparishcouncil.gov.uk			
eastgrinstead.gov.uk			
eynsham-pc.gov.uk			
ogc.gov.uk			
cornwall-ifca.gov.uk			
holwellparishcouncil.gov.uk			
cwmbran.gov.uk			
corfemullen-pc.gov.uk			
lingfieldparishcouncil.gov.uk			
copfs.gov.uk			
conwy.gov.uk			
ashbournetowncouncil.gov.uk			
congresbury-pc.gov.uk			
holmevalleyparishcouncil.gov.uk			
comptonshawford-pc.gov.uk			
holcomberogus-pc.gov.uk			
comptondundon-pc.gov.uk			
unedddatacymru.gov.uk			
communitysafetyni.gov.uk			
communities-ni.gov.uk			
handiprepared.gov.uk			
csc.gov.uk			
cymruhanesyddol.gov.uk			
communicationswhitepaper.gov.uk			
colwyn-tc.gov.uk			
colneyheathparishcouncil.gov.uk			
yorkshirelca.gov.uk			
ercallmagnaparishcouncil.gov.uk			
coleshilltowncouncil.gov.uk			
industrialcourt.gov.uk			
hailsham-tc.gov.uk			
clenchwarton-pc.gov.uk			
saltfordparishcouncil.gov.uk			
colerainebc.gov.uk			
pangbourne-pc.gov.uk			
colehill.gov.uk			
mhtscot.gov.uk			
coldencommon-pc.gov.uk			
historicscotlandimages.gov.uk			
salfordpriors.gov.uk			
coldhigham-pc.gov.uk			
northkilworthparishcouncil.gov.uk			
historic-scotland.gov.uk			
eppingtowncouncil.gov.uk			
chapel-en-le-frithparishcouncil.gov.uk			
coldharbour-pc.gov.uk			
csoni.gov.uk			
dummerparishcouncil.gov.uk			
colby-banningham-pc.gov.uk			
witley-pc.gov.uk			
bracklacommunitycouncil.gov.uk			
coflein.gov.uk			
clitheroetowncouncil.gov.uk			
ipa.gov.uk			
droitwichspa.gov.uk			
hexhamtowncouncil.gov.uk			
DinningtonParishCouncil.gov.uk			
clophill-pc.gov.uk			
speldhurstparishcouncil.gov.uk			
dingley-pc.gov.uk			
petersfield-tc.gov.uk			
cliffeandcliffewoods-pc.gov.uk			
innovateuk.gov.uk			
aberystwyth.gov.uk			
clevelandfire.gov.uk			
colerne-pc.gov.uk			
clentparishcouncil.gov.uk			
northweald-pc.gov.uk			
cambsfire.gov.uk			
londonscb.gov.uk			
curdridge-pc.gov.uk			
claw.gov.uk			
shenley-pc.gov.uk			
cullomptontowncouncil.gov.uk			
foweytowncouncil.gov.uk			
framptononsevern-pc.gov.uk			
broadbridgeheath-pc.gov.uk			
belmontrural-pc.gov.uk			
forestrow.gov.uk			
bozeatparishcouncil.gov.uk			
coedffranc-wcc.gov.uk			
GwentArchives.gov.uk			
civilservice.gov.uk			
witham3idb.gov.uk			
lancsmuseums.gov.uk			
cobham-kent-pc.gov.uk			
gwarchodyglannaucymru.gov.uk			
warwicktowncouncil.gov.uk			
devonbuildingcontrol.gov.uk			
llanelli-rural.gov.uk			
cinderfordtowncouncil.gov.uk			
lgbc-scotland.gov.uk			
elloughtonbrough-pc.gov.uk			
wem.gov.uk			
devonandcornwall-pcc.gov.uk			
buildingregulationsni.gov.uk			
ellisfield.gov.uk			
livingwage.gov.uk			
cromer-tc.gov.uk			
cringlefordparishcouncil.gov.uk			
waretowncouncil.gov.uk			
churchknowle-pc.gov.uk			
havant.gov.uk			
churchillandblakedown-pc.gov.uk			
berrow-somerset-pc.gov.uk			
ferryhill.gov.uk			
avonandsomerset-pcc.gov.uk			
dvtaonlineni.gov.uk			
cholmondestonandwettenhall-pc.gov.uk			
humbersidefire.gov.uk			
walesprobationtrust.gov.uk			
chiseldon-pc.gov.uk			
holbeton-pc.gov.uk			
thamesvalley-pcc.gov.uk			
jobcentre.gov.uk			
itchingfieldparishcouncil.gov.uk			
chineham.gov.uk			
ducklingtonparishcouncil.gov.uk			
aspleyguiseparishcouncil.gov.uk			
chilhamparishcouncil.gov.uk			
upperbeeding-pc.gov.uk			
lpsni.gov.uk			
saxilbyparishcouncil.gov.uk			
saxbyallsaints-pc.gov.uk			
ugboroughparishcouncil.gov.uk			
cheveningparishcouncil.gov.uk			
holsworthytowncouncil.gov.uk			
chestfieldparishcouncil.gov.uk			
addingham-pc.gov.uk			
chinleybuxworthbrownside-pc.gov.uk			
decymru-tan.gov.uk			
clacks.gov.uk			
tuxford-pc.gov.uk			
cheshirefire.gov.uk			
leightonlinslade-tc.gov.uk			
hythe-tc.gov.uk			
trimdonfoundry-pc.gov.uk			
hackney.gov.uk			
charmouthparishcouncil.gov.uk			
charlwoodparishcouncil.gov.uk			
denbighshire.gov.uk			
ollerton-tc.gov.uk			
sealandcommunitycouncil.gov.uk			
CharltonKingsParishCouncil.gov.uk			
cardiff.gov.uk			
emcouncils.gov.uk			
actoncommunitycouncil.gov.uk			
llanfaelogcommunitycouncil.gov.uk			
chalfontstgiles-pc.gov.uk			
chacombeparishcouncil.gov.uk			
transportforgreatermanchestercommittee.gov.uk			
hessletowncouncil.gov.uk			
bromorgannwg.gov.uk			
ceredigion.gov.uk			
hscic.gov.uk			
chudleigh-tc.gov.uk			
bagilltcommunitycouncil.gov.uk			
horsforthtowncouncil.gov.uk			
christleton-pc.gov.uk			
snaintonparishcouncil.gov.uk			
cbhc.gov.uk			
warfieldparishcouncil.gov.uk			
publicguardian-scotland.gov.uk			
mi5.gov.uk			
blaenhonddan-wcc.gov.uk			
catshillandnorthmarlbrook-pc.gov.uk			
walthamforest.gov.uk			
horsmonden-pc.gov.uk			
pembreyburryport-tc.gov.uk			
castonparishcouncil.gov.uk			
dursleytowncouncil.gov.uk			
haydonwick.gov.uk			
rhondda-cynon-taf.gov.uk			
attorneygeneral.gov.uk			
mhtscotland.gov.uk			
castleedenparishcouncil.gov.uk			
chard.gov.uk			
wimborne.gov.uk			
carterton-tc.gov.uk			
resilience.gov.uk			
peacehaventowncouncil.gov.uk			
metheringham-pc.gov.uk			
carmarthentowncouncil.gov.uk			
carmarthenshire.gov.uk			
capitalforenterprise.gov.uk			
lanliveryparishcouncil.gov.uk			
canolfanbydgwaith.gov.uk			
bradfield-yorks-pc.gov.uk			
reephamnorfolk-tc.gov.uk			
nfi.gov.uk			
camden.gov.uk			
biggleswadetowncouncil.gov.uk			
readydumgal.gov.uk			
cambourneparishcouncil.gov.uk			
camborne-tc.gov.uk			
calne.gov.uk			
callington-tc.gov.uk			
romsleyparishcouncil.gov.uk			
bletchleyfennystratford-tc.gov.uk			
cesg.gov.uk			
ferndown.gov.uk			
malvernwells-pc.gov.uk			
caldecote.gov.uk			
caiapark.gov.uk			
caerffili.gov.uk			
hornsea.gov.uk			
brynfordcommunitycouncil.gov.uk			
charitycommission.gov.uk			
churchpreen-hughley-kenley-pc.gov.uk			
cabinet-office.gov.uk			
maghull-tc.gov.uk			
harrow.gov.uk			
buywithconfidence.gov.uk			
crownoffice.gov.uk			
maethugogleddcymru.gov.uk			
bollington-tc.gov.uk			
batchworth-pc.gov.uk			
business.gov.uk			
boldreparishcouncil.gov.uk			
anston.gov.uk			
madeleytowncouncil.gov.uk			
yatton-pc.gov.uk			
pewsey-pc.gov.uk			
macclesfield-tc.gov.uk			
burwellparishcouncil.gov.uk			
burtonparishcouncil.gov.uk			
olneytowncouncil.gov.uk			
publow-with-pensford-pc.gov.uk			
oldbolsovertowncouncil.gov.uk			
newbradwell-pc.gov.uk			
burrator.gov.uk			
publiccontractsscotland.gov.uk			
burntwood-tc.gov.uk			
burnhamparish.gov.uk			
burnhamoncrouchtowncouncil.gov.uk			
hettontowncouncil.gov.uk			
clydeplan-sdpa.gov.uk			
suttonunderwhitestonecliffeparishcouncil.gov.uk			
elswickparishcouncil.gov.uk			
blackwaterandhawleytowncouncil.gov.uk			
dardni.gov.uk			
berwick-tc.gov.uk			
prescot-tc.gov.uk			
blackbirdleysparishcouncil.gov.uk			
dasscotland.gov.uk			
bungaytowncouncil.gov.uk			
greatbardfield-pc.gov.uk			
cranbrooktowncouncil.gov.uk			
pembrokeshire.gov.uk			
glastonbury.gov.uk			
holywell-town.gov.uk			
ponthircommunitycouncil.gov.uk			
buckhursthillpc.gov.uk			
billingshurst.gov.uk			
buckfastleigh.gov.uk			
pointsoflight.gov.uk			
woottonbassett.gov.uk			
brutontowncouncil.gov.uk			
pocklington.gov.uk			
beaumaristowncouncil.gov.uk			
nics.gov.uk			
galwgofal.gov.uk			
broughtonandmkv-pc.gov.uk			
broughtonandbrettoncommunitycouncil.gov.uk			
hatfield-herts.gov.uk			
longashtonparishcouncil.gov.uk			
chipperfieldparishcouncil.gov.uk			
langwithparishcouncil.gov.uk			
campbell-park.gov.uk			
bracknell.gov.uk			
budleighsaltertontowncouncil.gov.uk			
londonresilience.gov.uk			
delni.gov.uk			
curriculumforexcellencescotland.gov.uk			
pco.gov.uk			
alderburyparishcouncil.gov.uk			
foxtonparishcouncil.gov.uk			
brixhamtowncouncil.gov.uk			
billingeparishcouncil.gov.uk			
RedbournParishCouncil.gov.uk			
londoncouncils.gov.uk			
laugharnetownship-wcc.gov.uk			
hull.gov.uk			
blog.gov.uk			
langport-tc.gov.uk			
brinsworthparishcouncil.gov.uk			
witney-tc.gov.uk			
landwebni.gov.uk			
brinkworthparishcouncil.gov.uk			
leicestershireandrutlandalc.gov.uk			
londoncareplacements.gov.uk			
bexley.gov.uk			
brimscombeandthrupp-pc.gov.uk			
lancingparishcouncil.gov.uk			
Brierfield.gov.uk			
penistonetowncouncil.gov.uk			
bridport-tc.gov.uk			
bridgend.gov.uk			
torfaen.gov.uk			
lwarb.gov.uk			
tormarton-pc.gov.uk			
gmita.gov.uk			
powys.gov.uk			
conwytowncouncil.gov.uk			
brent.gov.uk			
tfgmc.gov.uk			
newenttowncouncil.gov.uk			
welton-by-lincoln-pc.gov.uk			
llanasacommunitycouncil.gov.uk			
windleshampc.gov.uk			
bredenburygroup-pc.gov.uk			
bridlington.gov.uk			
eastmidlandsfire-recruitment.gov.uk			
brayparishcouncil.gov.uk			
northhinksey-pc.gov.uk			
featherstoneandbrinsfordparishcouncil.gov.uk			
brauntonparishcouncil.gov.uk			
brandonandbyshottlesparishcouncil.gov.uk			
backwell-pc.gov.uk			
towednackparishcouncil.gov.uk			
bramshottandliphook-pc.gov.uk			
infrastructure-ni.gov.uk			
odcombeparishcouncil.gov.uk			
landlordregistrationscotland.gov.uk			
greenwich.gov.uk			
bradwell-pc.gov.uk			
painswick-pc.gov.uk			
bradninch-tc.gov.uk			
launton-pc.gov.uk			
scotcourts.gov.uk			
melton-suffolk-pc.gov.uk			
canveyisland-tc.gov.uk			
bradleystoke.gov.uk			
brading.gov.uk			
eastington-pc.gov.uk			
bracknelltowncouncil.gov.uk			
bracknellforest.gov.uk			
eastherts.gov.uk			
coggeshall-pc.gov.uk			
southkirkbyandmoorthorpetowncouncil.gov.uk			
brackleynorthants-tc.gov.uk			
ni-assembly.gov.uk			
pertonparishcouncil.gov.uk			
northtyneside.gov.uk			
boveytracey.gov.uk			
roundwayparishcouncil.gov.uk			
bournheath-pc.gov.uk			
ratingreviewni.gov.uk			
marshgibbon-pc.gov.uk			
staustell-tc.gov.uk			
niaur.gov.uk			
boroughgreen.gov.uk			
amotherby-pc.gov.uk			
Haddenham-bucks-pc.gov.uk			
atherstone-tc.gov.uk			
dunstable.gov.uk			
woodley.gov.uk			
claygateparishcouncil.gov.uk			
bognorregis.gov.uk			
bodfaricommunitycouncil.gov.uk			
hagleyparishcouncil.gov.uk			
AbergavennyTownCouncil.gov.uk			
keynsham-tc.gov.uk			
bluelight.gov.uk			
rawcliffeparishcouncil.gov.uk			
digitalni.gov.uk			
blpd.gov.uk			
alg.gov.uk			
westmidlandsiep.gov.uk			
kennington-pc.gov.uk			
wollastonparishcouncil.gov.uk			
eastern-ifca.gov.uk			
chickerell-tc.gov.uk			
highamferrers-tc.gov.uk			
burwarton-pc.gov.uk			
aasb-ni.gov.uk			
cmktowncouncil.gov.uk			
dcalni.gov.uk			
blacknotley-pc.gov.uk			
lydiardmillicent-pc.gov.uk			
sussex-ifca.gov.uk			
blacknest.gov.uk			
salisburycitycouncil.gov.uk			
colefordtowncouncil.gov.uk			
wolvertonandgreenleystowncouncil.gov.uk			
hta.gov.uk			
westhoathly.gov.uk			
bisley-with-lypiatt.gov.uk			
glynneathtowncouncil.gov.uk			
electoralofficeni.gov.uk			
bishopswaltham-pc.gov.uk			
bishopscanningsparishcouncil.gov.uk			
justiceinspectorates.gov.uk			
bishopauckland-tc.gov.uk			
overstone-pc.gov.uk			
hseni.gov.uk			
dfpni.gov.uk			
poolparishcouncil.gov.uk			
biodiversityscotland.gov.uk			
bingleytowncouncil.gov.uk			
greathorkesley-pc.gov.uk			
chippenham.gov.uk			
hednesford-tc.gov.uk			
ofqual.gov.uk			
anglesey.gov.uk			
brymptonparishcouncil.gov.uk			
health-ni.gov.uk			
csa.gov.uk			
easingwold.gov.uk			
bideford-tc.gov.uk			
axminstertowncouncil.gov.uk			
earlsbarton.gov.uk			
biddenhamparishcouncil.gov.uk			
bickleigh.gov.uk			
snh.gov.uk			
economy-ni.gov.uk			
comeytrowe-pc.gov.uk			
bicester.gov.uk			
bewerleyparishcouncil.gov.uk			
beverley.gov.uk			
honiton.gov.uk			
berkswich-pc.gov.uk			
chesham.gov.uk			
berkeley-tc.gov.uk			
nash-bucks-pc.gov.uk			
kirkbymoorsidetowncouncil.gov.uk			
pontypoolcc.gov.uk			
belpertowncouncil.gov.uk			
portlandtowncouncil.gov.uk			
belfaststreetsaheadni.gov.uk			
enfield.gov.uk			
nailsworthtowncouncil.gov.uk			
belfastcity.gov.uk			
glasgow.gov.uk			
ludlow.gov.uk			
hmic.gov.uk			
stivestowncouncil.gov.uk			
notts-fire.gov.uk			
woolston-pc.gov.uk			
burton-in-kendal-pc.gov.uk			
kidderminstertowncouncil.gov.uk			
hmcpsi.gov.uk			
beawarekidsni.gov.uk			
dorset-aptc.gov.uk			
wrestlingworthandcockaynehatley-pc.gov.uk			
leamingtonspatowncouncil.gov.uk			
dorchester-tc.gov.uk			
beaconsfieldtowncouncil.gov.uk			
isycoedcommunitycouncil.gov.uk			
galleywoodparishcouncil.gov.uk			
cyngortrefcaerfyrddin.gov.uk			
baughurst-pc.gov.uk			
woottonparishcouncil.gov.uk			
monmouthshire.gov.uk			
basildon.gov.uk			
bartestreewithlugwardinegroup-pc.gov.uk			
barrytowncouncil.gov.uk			
barnoldswicktowncouncil.gov.uk			
BarnardCastleTownCouncil.gov.uk			
barmouthtowncouncil.gov.uk			
southwark.gov.uk			
barlingmagna-pc.gov.uk			
barking-dagenham.gov.uk			
hanborough-pc.gov.uk			
bamptontowncouncil.gov.uk			
bamptonoxon-parishcouncil.gov.uk			
finedonparishcouncil.gov.uk			
dexeu.gov.uk			
ballymoney.gov.uk			
baldertonparishcouncil.gov.uk			
bakewelltowncouncil.gov.uk			
ddfire.gov.uk			
baildontowncouncil.gov.uk			
wirksworthtowncouncil.gov.uk			
ayrshire-vjb.gov.uk			
christowparishcouncil.gov.uk			
midhurst-tc.gov.uk			
begbroke-pc.gov.uk			
badgerfarmparishcouncil.gov.uk			
localdirect.gov.uk			
executiveoffice-ni.gov.uk			
direct.gov.uk			
northeastfire.gov.uk			
eureferendum.gov.uk			
ayrshire-jsu.gov.uk			
cheshiresharedservices.gov.uk			
cheshire-pcc.gov.uk			
abbotslangley-pc.gov.uk			
humberside-pcc.gov.uk			
aylesburytowncouncil.gov.uk			
marchtowncouncil.gov.uk			
st-ive-parishcouncil.gov.uk			
churchwithchapelbrampton-pc.gov.uk			
kidlington-pc.gov.uk			
avonfire.gov.uk			
comisiwnelusennau.gov.uk			
greatchesterford-pc.gov.uk			
duston-pc.gov.uk			
avening-pc.gov.uk			
chedzoyparishcouncil.gov.uk			
combemartin-pc.gov.uk			
alton.gov.uk			
greatbedwyn-pc.gov.uk			
howden-tc.gov.uk			
wendover-pc.gov.uk			
internalauditscotland.gov.uk			
hambleparishcouncil.gov.uk			
cosla.gov.uk			
attorney-general.gov.uk			
lichfield.gov.uk			
witherleyparishcouncil.gov.uk			
landrakeparishcouncil.gov.uk			
chandlersford-pc.gov.uk			
yatetowncouncil.gov.uk			
emersonsgreen-tc.gov.uk			
bodmin.gov.uk			
watermead-pc.gov.uk			
verwood.gov.uk			
assemblyni.gov.uk			
warwickshire-pcc.gov.uk			
public-standards.gov.uk			
blandfordforum-tc.gov.uk			
itt-ew.gov.uk			
cirencester.gov.uk			
chalford-glos.gov.uk			
blaenau-gwent.gov.uk			
chalfontstpeter-pc.gov.uk			
blacksluiceidb.gov.uk			
coxgreen.gov.uk			
asntscotland.gov.uk			
barlestoneparishcouncil.gov.uk			
whitbytowncouncil.gov.uk			
lambeth.gov.uk			
alderholtparishcouncil.gov.uk			
fremingtonparishcouncil.gov.uk			
basildon-berks-pc.gov.uk			
bardneygroup-pc.gov.uk			
ashover-pc.gov.uk			
thornley-pc.gov.uk			
crickladetowncouncil.gov.uk			
leektowncouncil.gov.uk			
hamptonbishopparishcouncil.gov.uk			
bishopsstortfordtc.gov.uk			
higham-kent-pc.gov.uk			
biddenden.gov.uk			
armaghbanbridgecraigavon.gov.uk			
stainforthtowncouncil.gov.uk			
NorthallertonTownCouncil.gov.uk			
southpethertonparishcouncil.gov.uk			
denbyparishcouncil.gov.uk			
argoedcommunitycouncil.gov.uk			
pulboroughparishcouncil.gov.uk			
oldmarston-pc.gov.uk			
denbightowncouncil.gov.uk			
ofgem.gov.uk			
ardsandnorthdown.gov.uk			
arclidparishcouncil.gov.uk			
archifaumorgannwg.gov.uk			
favershamtowncouncil.gov.uk			
neath-porttalbot.gov.uk			
hawkwellparishcouncil.gov.uk			
appsi.gov.uk			
appletonroebuckandacasterselby-pc.gov.uk			
official-documents.gov.uk			
lustonparishes.gov.uk			
dauntseyparishcouncil.gov.uk			
luddesdown-pc.gov.uk			
dataunitwales.gov.uk			
register.gov.uk			
worcester.gov.uk			
twict.gov.uk			
cockshuttcumpetton-pc.gov.uk			
amersham-tc.gov.uk			
amble.gov.uk			
alvechurch.gov.uk			
houndparishcouncil.gov.uk			
great-aycliffe.gov.uk			
ravenfieldparishcouncil.gov.uk			
yateley-tc.gov.uk			
alpha.gov.uk			
northcave-pc.gov.uk			
alnwick-tc.gov.uk			
beaminster-tc.gov.uk			
northantsfire.gov.uk			
lytchettminsterandupton-tc.gov.uk			
allhallowskent-pc.gov.uk			
alkboroughwalcotparishcouncil.gov.uk			
EffinghamParishCouncil.gov.uk			
tockwith.gov.uk			
lslo.gov.uk			
bishopmiddleham-pc.gov.uk			
claybrookemagnaparishcouncil.gov.uk			
oakhamtowncouncil.gov.uk			
birchington-pc.gov.uk			
aldenham-pc.gov.uk			
catcottparishcouncil.gov.uk			
lisburncityandcastlereagh.gov.uk			
caerdydd.gov.uk			
oundle.gov.uk			
ofgas.gov.uk			
martock-pc.gov.uk			
akeleyparishcouncil.gov.uk			
essingtonparishcouncil.gov.uk			
overtonparishcouncil.gov.uk			
aiskewleemingbar-pc.gov.uk			
gosfordandwatereaton-pc.gov.uk			
aib.gov.uk			
andover-tc.gov.uk			
ago.gov.uk			
eardington-pc.gov.uk			
markyateparishcouncil.gov.uk			
henfield.gov.uk			
chelmsleywood-tc.gov.uk			
adjudicatorsoffice.gov.uk			
marhamchurch-pc.gov.uk			
acurriculumforexcellencescotland.gov.uk			
colwichparishcouncil.gov.uk			
acoba.gov.uk			
ac-decymru.gov.uk			
kidwelly.gov.uk			
accounts-commission.gov.uk			
stoke-pc-worcs.gov.uk			
accountni.gov.uk			
queenthorneparishcouncil.gov.uk			
caldecott-pc.gov.uk			
haworthcrossroadsstanbury-pc.gov.uk			
angleseystaffs-pc.gov.uk			
abingdon.gov.uk			
abertilleryandllanhilleth-wcc.gov.uk			
abertawe.gov.uk			
gchq.gov.uk			
crudwell-pc.gov.uk			
ilminster.gov.uk			
aberdeencity.gov.uk			
huntingdontown.gov.uk			
allbrookandnorthboyatt-pc.gov.uk			
haytowncouncil.gov.uk			
littledunham-pc.gov.uk			
scottishcounciltaxbands.gov.uk			
mardenkent-pc.gov.uk			
sandfordparishcouncil.gov.uk			
legislation.gov.uk			
congleton-tc.gov.uk			
stowe-by-chartley-pc.gov.uk			
rcahms.gov.uk			
